date,region,non_icu_beds_total,non_icu_beds_occupied,non_icu_beds_available,non_icu_beds_non_covid,non_icu_beds_covid,icu_beds_total,icu_beds_occupied,icu_beds_available,icu_beds_non_covid,icu_beds_covid,metro,report_date
2021-01-01,Central,808,568,240,492,76,96,67,29,47,20,Greater MN,2022-07-14
2021-01-01,Metro,3748,3209,539,2834,375,872,710,162,594,116,Metro,2022-07-14
2021-01-01,Northeast,979,527,452,452,75,114,79,35,64,15,Greater MN,2022-07-14
2021-01-01,Northwest,322,168,154,144,24,29,10,19,8,2,Greater MN,2022-07-14
2021-01-01,South Central,412,184,228,151,33,25,11,14,9,2,Greater MN,2022-07-14
2021-01-01,Southeast,1359,836,523,781,55,256,153,103,136,17,Greater MN,2022-07-14
2021-01-01,Southwest,368,169,199,138,31,14,3,11,1,2,Greater MN,2022-07-14
2021-01-01,State,8193,5725,2468,5045,680,1422,1038,384,861,177,State,2022-07-14
2021-01-01,West Central,197,64,133,53,11,16,5,11,2,3,Greater MN,2022-07-14
2022-01-01,Central,715,584,131,454,130,110,102,8,54,48,Greater MN,2022-07-14
2022-01-01,Metro,3878,3713,165,3057,656,843,742,101,576,166,Metro,2022-07-14
2022-01-01,Northeast,811,490,321,428,62,112,91,21,64,27,Greater MN,2022-07-14
2022-01-01,Northwest,274,144,130,124,20,28,12,16,6,6,Greater MN,2022-07-14
2022-01-01,South Central,349,204,145,161,43,22,11,11,6,5,Greater MN,2022-07-14
2022-01-01,Southeast,1302,954,348,883,71,250,175,75,133,42,Greater MN,2022-07-14
2022-01-01,Southwest,362,147,215,130,17,15,9,6,5,4,Greater MN,2022-07-14
2022-01-01,State,7867,6321,1546,5306,1015,1395,1147,248,848,299,State,2022-07-14
2022-01-01,West Central,176,85,91,69,16,15,5,10,4,1,Greater MN,2022-07-14
2021-01-02,Central,779,513,266,448,65,89,58,31,41,17,Greater MN,2022-07-14
2021-01-02,Metro,3670,3059,611,2704,355,848,670,178,555,115,Metro,2022-07-14
2021-01-02,Northeast,972,497,475,425,72,112,80,32,64,16,Greater MN,2022-07-14
2021-01-02,Northwest,322,173,149,150,23,29,10,19,8,2,Greater MN,2022-07-14
2021-01-02,South Central,411,201,210,165,36,27,9,18,8,1,Greater MN,2022-07-14
2021-01-02,Southeast,1351,798,553,736,62,254,129,125,116,13,Greater MN,2022-07-14
2021-01-02,Southwest,362,151,211,123,28,15,4,11,2,2,Greater MN,2022-07-14
2021-01-02,State,8073,5466,2607,4814,652,1393,967,426,799,168,State,2022-07-14
2021-01-02,West Central,206,74,132,63,11,19,7,12,5,2,Greater MN,2022-07-14
2022-01-02,Central,710,579,131,446,133,109,99,10,53,46,Greater MN,2022-07-14
2022-01-02,Metro,3812,3621,191,2945,676,835,744,91,585,159,Metro,2022-07-14
2022-01-02,Northeast,796,498,298,438,60,112,84,28,58,26,Greater MN,2022-07-14
2022-01-02,Northwest,271,147,124,129,18,28,14,14,8,6,Greater MN,2022-07-14
2022-01-02,South Central,350,206,144,161,45,22,11,11,7,4,Greater MN,2022-07-14
2022-01-02,Southeast,1300,948,352,870,78,249,170,79,133,37,Greater MN,2022-07-14
2022-01-02,Southwest,357,134,223,113,21,13,6,7,2,4,Greater MN,2022-07-14
2022-01-02,State,7772,6224,1548,5178,1046,1383,1131,252,848,283,State,2022-07-14
2022-01-02,West Central,176,91,85,76,15,15,3,12,2,1,Greater MN,2022-07-14
2021-01-03,Central,778,515,263,447,68,97,66,31,46,20,Greater MN,2022-07-14
2021-01-03,Metro,3587,3053,534,2680,373,828,669,159,565,104,Metro,2022-07-14
2021-01-03,Northeast,967,470,497,409,61,112,80,32,64,16,Greater MN,2022-07-14
2021-01-03,Northwest,325,178,147,152,26,29,10,19,8,2,Greater MN,2022-07-14
2021-01-03,South Central,409,195,214,163,32,28,10,18,8,2,Greater MN,2022-07-14
2021-01-03,Southeast,1344,789,555,721,68,253,128,125,117,11,Greater MN,2022-07-14
2021-01-03,Southwest,365,143,222,118,25,14,3,11,1,2,Greater MN,2022-07-14
2021-01-03,State,7972,5418,2554,4758,660,1377,971,406,812,159,State,2022-07-14
2021-01-03,West Central,197,75,122,68,7,16,5,11,3,2,Greater MN,2022-07-14
2022-01-03,Central,725,601,124,468,133,112,100,12,58,42,Greater MN,2022-07-14
2022-01-03,Metro,3816,3651,165,2949,702,833,729,104,564,165,Metro,2022-07-14
2022-01-03,Northeast,799,504,295,442,62,112,76,36,52,24,Greater MN,2022-07-14
2022-01-03,Northwest,274,165,109,148,17,28,18,10,9,9,Greater MN,2022-07-14
2022-01-03,South Central,352,202,150,163,39,22,11,11,6,5,Greater MN,2022-07-14
2022-01-03,Southeast,1308,966,342,875,91,252,174,78,131,43,Greater MN,2022-07-14
2022-01-03,Southwest,351,131,220,110,21,13,6,7,2,4,Greater MN,2022-07-14
2022-01-03,State,7801,6315,1486,5237,1078,1387,1118,269,825,293,State,2022-07-14
2022-01-03,West Central,176,95,81,82,13,15,4,11,3,1,Greater MN,2022-07-14
2021-01-04,Central,787,550,237,477,73,92,64,28,45,19,Greater MN,2022-07-14
2021-01-04,Metro,3614,3119,495,2720,399,831,661,170,562,99,Metro,2022-07-14
2021-01-04,Northeast,971,484,487,421,63,114,74,40,56,18,Greater MN,2022-07-14
2021-01-04,Northwest,326,176,150,152,24,29,16,13,13,3,Greater MN,2022-07-14
2021-01-04,South Central,398,212,186,184,28,28,10,18,7,3,Greater MN,2022-07-14
2021-01-04,Southeast,1349,786,563,714,72,253,116,137,106,10,Greater MN,2022-07-14
2021-01-04,Southwest,366,141,225,115,26,14,2,12,1,1,Greater MN,2022-07-14
2021-01-04,State,8016,5545,2471,4854,691,1381,949,432,794,155,State,2022-07-14
2021-01-04,West Central,205,77,128,71,6,20,6,14,4,2,Greater MN,2022-07-14
2022-01-04,Central,742,649,93,510,139,117,104,13,65,39,Greater MN,2022-07-14
2022-01-04,Metro,3984,3849,135,3111,738,830,742,88,578,164,Metro,2022-07-14
2022-01-04,Northeast,780,515,265,445,70,112,84,28,60,24,Greater MN,2022-07-14
2022-01-04,Northwest,265,173,92,155,18,28,16,12,8,8,Greater MN,2022-07-14
2022-01-04,South Central,324,241,83,201,40,22,9,13,4,5,Greater MN,2022-07-14
2022-01-04,Southeast,1289,1005,284,925,80,251,191,60,151,40,Greater MN,2022-07-14
2022-01-04,Southwest,348,127,221,105,22,13,8,5,4,4,Greater MN,2022-07-14
2022-01-04,State,7910,6673,1237,5551,1122,1388,1158,230,873,285,State,2022-07-14
2022-01-04,West Central,178,114,64,99,15,15,4,11,3,1,Greater MN,2022-07-14
2021-01-05,Central,786,580,206,509,71,106,70,36,54,16,Greater MN,2022-07-14
2021-01-05,Metro,3903,3568,335,3171,397,841,694,147,601,93,Metro,2022-07-14
2021-01-05,Northeast,969,491,478,425,66,114,82,32,68,14,Greater MN,2022-07-14
2021-01-05,Northwest,326,178,148,155,23,29,18,11,16,2,Greater MN,2022-07-14
2021-01-05,South Central,409,221,188,194,27,28,10,18,9,1,Greater MN,2022-07-14
2021-01-05,Southeast,1345,853,492,784,69,256,138,118,127,11,Greater MN,2022-07-14
2021-01-05,Southwest,367,136,231,116,20,15,3,12,2,1,Greater MN,2022-07-14
2021-01-05,State,8311,6136,2175,5456,680,1408,1023,385,883,140,State,2022-07-14
2021-01-05,West Central,206,109,97,102,7,19,8,11,6,2,Greater MN,2022-07-14
2022-01-05,Central,792,696,96,553,143,123,107,16,68,39,Greater MN,2022-07-14
2022-01-05,Metro,4165,4039,126,3254,785,831,751,80,593,158,Metro,2022-07-14
2022-01-05,Northeast,780,544,236,462,82,112,85,27,62,23,Greater MN,2022-07-14
2022-01-05,Northwest,281,177,104,157,20,28,15,13,9,6,Greater MN,2022-07-14
2022-01-05,South Central,325,243,82,209,34,22,12,10,8,4,Greater MN,2022-07-14
2022-01-05,Southeast,1306,1096,210,993,103,251,197,54,162,35,Greater MN,2022-07-14
2022-01-05,Southwest,347,138,209,108,30,13,10,3,6,4,Greater MN,2022-07-14
2022-01-05,State,8205,7098,1107,5883,1215,1395,1183,212,911,272,State,2022-07-14
2022-01-05,West Central,209,165,44,147,18,15,6,9,3,3,Greater MN,2022-07-14
2021-01-06,Central,827,601,226,538,63,109,68,41,53,15,Greater MN,2022-07-14
2021-01-06,Metro,4119,3709,410,3326,383,846,690,156,603,87,Metro,2022-07-14
2021-01-06,Northeast,957,516,441,455,61,114,82,32,68,14,Greater MN,2022-07-14
2021-01-06,Northwest,341,182,159,157,25,30,19,11,16,3,Greater MN,2022-07-14
2021-01-06,South Central,417,221,196,190,31,24,9,15,8,1,Greater MN,2022-07-14
2021-01-06,Southeast,1365,895,470,831,64,258,166,92,154,12,Greater MN,2022-07-14
2021-01-06,Southwest,381,164,217,142,22,14,2,12,2,0,Greater MN,2022-07-14
2021-01-06,State,8645,6412,2233,5757,655,1414,1044,370,909,135,State,2022-07-14
2021-01-06,West Central,238,124,114,118,6,19,8,11,5,3,Greater MN,2022-07-14
2022-01-06,Central,773,679,94,537,142,119,106,13,64,42,Greater MN,2022-07-14
2022-01-06,Metro,3985,3899,86,3135,764,832,751,81,601,150,Metro,2022-07-14
2022-01-06,Northeast,763,535,228,449,86,112,83,29,59,24,Greater MN,2022-07-14
2022-01-06,Northwest,274,180,94,158,22,28,19,9,12,7,Greater MN,2022-07-14
2022-01-06,South Central,321,247,74,216,31,22,12,10,7,5,Greater MN,2022-07-14
2022-01-06,Southeast,1295,1142,153,1033,109,250,201,49,164,37,Greater MN,2022-07-14
2022-01-06,Southwest,347,158,189,130,28,12,6,6,3,3,Greater MN,2022-07-14
2022-01-06,State,7926,6958,968,5758,1200,1390,1183,207,914,269,State,2022-07-14
2022-01-06,West Central,168,118,50,100,18,15,5,10,4,1,Greater MN,2022-07-14
2021-01-07,Central,804,600,204,542,58,103,65,38,51,14,Greater MN,2022-07-14
2021-01-07,Metro,3932,3556,376,3180,376,854,695,159,609,86,Metro,2022-07-14
2021-01-07,Northeast,956,485,471,424,61,114,80,34,69,11,Greater MN,2022-07-14
2021-01-07,Northwest,328,176,152,154,22,29,13,16,11,2,Greater MN,2022-07-14
2021-01-07,South Central,406,209,197,183,26,24,8,16,7,1,Greater MN,2022-07-14
2021-01-07,Southeast,1353,928,425,864,64,258,174,84,160,14,Greater MN,2022-07-14
2021-01-07,Southwest,376,158,218,141,17,14,3,11,3,0,Greater MN,2022-07-14
2021-01-07,State,8361,6206,2155,5574,632,1415,1046,369,916,130,State,2022-07-14
2021-01-07,West Central,206,94,112,86,8,19,8,11,6,2,Greater MN,2022-07-14
2022-01-07,Central,789,687,102,544,143,121,109,12,69,40,Greater MN,2022-07-14
2022-01-07,Metro,3960,3845,115,3077,768,819,751,68,612,139,Metro,2022-07-14
2022-01-07,Northeast,730,539,191,456,83,112,87,25,67,20,Greater MN,2022-07-14
2022-01-07,Northwest,263,174,89,147,27,28,18,10,12,6,Greater MN,2022-07-14
2022-01-07,South Central,307,235,72,208,27,22,11,11,7,4,Greater MN,2022-07-14
2022-01-07,Southeast,1289,1130,159,1036,94,251,205,46,166,39,Greater MN,2022-07-14
2022-01-07,Southwest,346,153,193,127,26,12,6,6,3,3,Greater MN,2022-07-14
2022-01-07,State,7848,6880,968,5698,1182,1381,1196,185,941,255,State,2022-07-14
2022-01-07,West Central,164,117,47,103,14,16,9,7,5,4,Greater MN,2022-07-14
2021-01-08,Central,816,604,212,553,51,101,61,40,46,15,Greater MN,2022-07-14
2021-01-08,Metro,3870,3493,377,3125,368,845,696,149,609,87,Metro,2022-07-14
2021-01-08,Northeast,809,479,330,431,48,114,82,32,66,16,Greater MN,2022-07-14
2021-01-08,Northwest,328,160,168,140,20,29,16,13,14,2,Greater MN,2022-07-14
2021-01-08,South Central,401,186,215,158,28,25,10,15,10,0,Greater MN,2022-07-14
2021-01-08,Southeast,1339,935,404,885,50,257,164,93,151,13,Greater MN,2022-07-14
2021-01-08,Southwest,368,143,225,129,14,14,5,9,5,0,Greater MN,2022-07-14
2021-01-08,State,8137,6086,2051,5499,587,1404,1041,363,906,135,State,2022-07-14
2021-01-08,West Central,206,86,120,78,8,19,7,12,5,2,Greater MN,2022-07-14
2022-01-08,Central,780,691,89,527,164,113,102,11,65,37,Greater MN,2022-07-14
2022-01-08,Metro,3821,3718,103,2978,740,832,755,77,611,144,Metro,2022-07-14
2022-01-08,Northeast,726,505,221,429,76,110,88,22,65,23,Greater MN,2022-07-14
2022-01-08,Northwest,274,181,93,157,24,28,16,12,10,6,Greater MN,2022-07-14
2022-01-08,South Central,303,227,76,202,25,22,11,11,4,7,Greater MN,2022-07-14
2022-01-08,Southeast,1318,1105,213,1006,99,253,200,53,162,38,Greater MN,2022-07-14
2022-01-08,Southwest,336,134,202,110,24,12,4,8,1,3,Greater MN,2022-07-14
2022-01-08,State,7721,6661,1060,5498,1163,1387,1183,204,922,261,State,2022-07-14
2022-01-08,West Central,163,100,63,89,11,17,7,10,4,3,Greater MN,2022-07-14
2021-01-09,Central,792,576,216,523,53,100,61,39,45,16,Greater MN,2022-07-14
2021-01-09,Metro,3773,3315,458,2986,329,844,689,155,605,84,Metro,2022-07-14
2021-01-09,Northeast,962,472,490,417,55,112,74,38,62,12,Greater MN,2022-07-14
2021-01-09,Northwest,329,147,182,131,16,29,15,14,13,2,Greater MN,2022-07-14
2021-01-09,South Central,383,175,208,152,23,26,11,15,11,0,Greater MN,2022-07-14
2021-01-09,Southeast,1357,930,427,885,45,255,156,99,142,14,Greater MN,2022-07-14
2021-01-09,Southwest,363,136,227,125,11,16,5,11,5,0,Greater MN,2022-07-14
2021-01-09,State,8165,5825,2340,5288,537,1401,1021,380,890,131,State,2022-07-14
2021-01-09,West Central,206,74,132,69,5,19,10,9,7,3,Greater MN,2022-07-14
2022-01-09,Central,773,680,93,518,162,104,90,14,56,34,Greater MN,2022-07-14
2022-01-09,Metro,3823,3692,131,2912,780,820,739,81,588,151,Metro,2022-07-14
2022-01-09,Northeast,729,506,223,425,81,110,86,24,63,23,Greater MN,2022-07-14
2022-01-09,Northwest,270,181,89,158,23,28,16,12,11,5,Greater MN,2022-07-14
2022-01-09,South Central,304,229,75,194,35,22,12,10,4,8,Greater MN,2022-07-14
2022-01-09,Southeast,1319,1050,269,941,109,250,179,71,143,36,Greater MN,2022-07-14
2022-01-09,Southwest,335,132,203,108,24,13,5,8,2,3,Greater MN,2022-07-14
2022-01-09,State,7717,6553,1164,5330,1223,1363,1131,232,869,262,State,2022-07-14
2022-01-09,West Central,164,83,81,74,9,16,4,12,2,2,Greater MN,2022-07-14
2021-01-10,Central,780,535,245,477,58,108,64,44,47,17,Greater MN,2022-07-14
2021-01-10,Metro,3717,3229,488,2907,322,814,660,154,568,92,Metro,2022-07-14
2021-01-10,Northeast,960,397,563,338,59,114,74,40,59,15,Greater MN,2022-07-14
2021-01-10,Northwest,329,148,181,133,15,29,15,14,13,2,Greater MN,2022-07-14
2021-01-10,South Central,406,167,239,143,24,25,8,17,8,0,Greater MN,2022-07-14
2021-01-10,Southeast,1359,851,508,801,50,256,145,111,132,13,Greater MN,2022-07-14
2021-01-10,Southwest,367,132,235,116,16,16,3,13,3,0,Greater MN,2022-07-14
2021-01-10,State,8124,5535,2589,4987,548,1381,979,402,838,141,State,2022-07-14
2021-01-10,West Central,206,76,130,72,4,19,10,9,8,2,Greater MN,2022-07-14
2022-01-10,Central,777,683,94,524,159,106,96,10,59,37,Greater MN,2022-07-14
2022-01-10,Metro,3779,3659,120,2832,827,827,738,89,591,147,Metro,2022-07-14
2022-01-10,Northeast,770,490,280,416,74,116,91,25,66,25,Greater MN,2022-07-14
2022-01-10,Northwest,273,191,82,165,26,28,19,9,13,6,Greater MN,2022-07-14
2022-01-10,South Central,321,240,81,205,35,22,11,11,5,6,Greater MN,2022-07-14
2022-01-10,Southeast,1313,1032,281,919,113,251,176,75,139,37,Greater MN,2022-07-14
2022-01-10,Southwest,344,137,207,114,23,13,7,6,4,3,Greater MN,2022-07-14
2022-01-10,State,7708,6519,1189,5251,1268,1401,1145,256,882,263,State,2022-07-14
2022-01-10,West Central,131,87,44,76,11,38,7,31,5,2,Greater MN,2022-07-14
2021-01-11,Central,753,528,225,471,57,109,68,41,52,16,Greater MN,2022-07-14
2021-01-11,Metro,3677,3157,520,2832,325,808,653,155,565,88,Metro,2022-07-14
2021-01-11,Northeast,962,513,449,454,59,114,70,44,59,11,Greater MN,2022-07-14
2021-01-11,Northwest,328,145,183,129,16,29,14,15,13,1,Greater MN,2022-07-14
2021-01-11,South Central,407,190,217,166,24,26,8,18,5,3,Greater MN,2022-07-14
2021-01-11,Southeast,1349,846,503,796,50,254,132,122,118,14,Greater MN,2022-07-14
2021-01-11,Southwest,364,138,226,118,20,14,3,11,3,0,Greater MN,2022-07-14
2021-01-11,State,8046,5601,2445,5043,558,1373,956,417,821,135,State,2022-07-14
2021-01-11,West Central,206,84,122,77,7,19,8,11,6,2,Greater MN,2022-07-14
2022-01-11,Central,742,658,84,509,149,116,104,12,64,40,Greater MN,2022-07-14
2022-01-11,Metro,3896,3738,158,2917,821,828,736,92,594,142,Metro,2022-07-14
2022-01-11,Northeast,754,486,268,403,83,114,86,28,63,23,Greater MN,2022-07-14
2022-01-11,Northwest,271,191,80,165,26,28,17,11,11,6,Greater MN,2022-07-14
2022-01-11,South Central,324,248,76,212,36,22,9,13,4,5,Greater MN,2022-07-14
2022-01-11,Southeast,1307,1068,239,969,99,252,191,61,156,35,Greater MN,2022-07-14
2022-01-11,Southwest,337,124,213,97,27,14,9,5,6,3,Greater MN,2022-07-14
2022-01-11,State,7790,6605,1185,5352,1253,1388,1159,229,902,257,State,2022-07-14
2022-01-11,West Central,159,92,67,80,12,14,7,7,4,3,Greater MN,2022-07-14
2021-01-12,Central,802,590,212,539,51,98,66,32,51,15,Greater MN,2022-07-14
2021-01-12,Metro,3771,3381,390,3059,322,830,669,161,581,88,Metro,2022-07-14
2021-01-12,Northeast,965,515,450,458,57,114,72,42,63,9,Greater MN,2022-07-14
2021-01-12,Northwest,328,166,162,151,15,29,13,16,10,3,Greater MN,2022-07-14
2021-01-12,South Central,415,212,203,186,26,24,6,18,6,0,Greater MN,2022-07-14
2021-01-12,Southeast,1355,908,447,866,42,246,146,100,133,13,Greater MN,2022-07-14
2021-01-12,Southwest,371,152,219,130,22,14,3,11,3,0,Greater MN,2022-07-14
2021-01-12,State,8212,6018,2194,5476,542,1375,981,394,852,129,State,2022-07-14
2021-01-12,West Central,205,94,111,87,7,20,6,14,5,1,Greater MN,2022-07-14
2022-01-12,Central,730,675,55,526,149,115,106,9,67,39,Greater MN,2022-07-14
2022-01-12,Metro,4145,4001,144,3109,892,847,761,86,619,142,Metro,2022-07-14
2022-01-12,Northeast,778,500,278,413,87,112,92,20,68,24,Greater MN,2022-07-14
2022-01-12,Northwest,285,201,84,177,24,24,18,6,11,7,Greater MN,2022-07-14
2022-01-12,South Central,323,237,86,199,38,22,12,10,8,4,Greater MN,2022-07-14
2022-01-12,Southeast,1302,1088,214,974,114,252,188,64,157,31,Greater MN,2022-07-14
2022-01-12,Southwest,357,133,224,103,30,14,9,5,6,3,Greater MN,2022-07-14
2022-01-12,State,8119,6979,1140,5629,1350,1398,1194,204,941,253,State,2022-07-14
2022-01-12,West Central,199,144,55,128,16,12,8,4,5,3,Greater MN,2022-07-14
2021-01-13,Central,851,634,217,577,57,93,56,37,44,12,Greater MN,2022-07-14
2021-01-13,Metro,4038,3614,424,3296,318,825,684,141,591,93,Metro,2022-07-14
2021-01-13,Northeast,965,519,446,470,49,112,79,33,70,9,Greater MN,2022-07-14
2021-01-13,Northwest,344,197,147,187,10,29,14,15,11,3,Greater MN,2022-07-14
2021-01-13,South Central,412,228,184,207,21,24,8,16,8,0,Greater MN,2022-07-14
2021-01-13,Southeast,1375,936,439,896,40,259,157,102,144,13,Greater MN,2022-07-14
2021-01-13,Southwest,386,160,226,142,18,14,2,12,2,0,Greater MN,2022-07-14
2021-01-13,State,8608,6416,2192,5894,522,1376,1008,368,877,131,State,2022-07-14
2021-01-13,West Central,237,128,109,119,9,20,8,12,7,1,Greater MN,2022-07-14
2022-01-13,Central,674,632,42,492,140,112,102,10,61,41,Greater MN,2022-07-14
2022-01-13,Metro,3991,3856,135,2965,891,812,741,71,601,140,Metro,2022-07-14
2022-01-13,Northeast,759,516,243,428,88,112,88,24,61,27,Greater MN,2022-07-14
2022-01-13,Northwest,256,166,90,144,22,25,18,7,11,7,Greater MN,2022-07-14
2022-01-13,South Central,322,247,75,204,43,23,12,11,8,4,Greater MN,2022-07-14
2022-01-13,Southeast,1300,1100,200,969,131,251,199,52,162,37,Greater MN,2022-07-14
2022-01-13,Southwest,337,124,213,96,28,11,6,5,4,2,Greater MN,2022-07-14
2022-01-13,State,7801,6742,1059,5386,1356,1358,1173,185,913,260,State,2022-07-14
2022-01-13,West Central,162,101,61,88,13,12,7,5,5,2,Greater MN,2022-07-14
2021-01-14,Central,850,630,220,571,59,92,54,38,44,10,Greater MN,2022-07-14
2021-01-14,Metro,3846,3433,413,3147,286,839,701,138,611,90,Metro,2022-07-14
2021-01-14,Northeast,973,499,474,454,45,112,78,34,68,10,Greater MN,2022-07-14
2021-01-14,Northwest,327,176,151,165,11,29,11,18,6,5,Greater MN,2022-07-14
2021-01-14,South Central,405,220,185,198,22,24,10,14,10,0,Greater MN,2022-07-14
2021-01-14,Southeast,1359,942,417,899,43,259,164,95,154,10,Greater MN,2022-07-14
2021-01-14,Southwest,375,147,228,130,17,15,1,14,1,0,Greater MN,2022-07-14
2021-01-14,State,8340,6150,2190,5658,492,1390,1030,360,905,125,State,2022-07-14
2021-01-14,West Central,205,103,102,94,9,20,11,9,11,0,Greater MN,2022-07-14
2022-01-14,Central,669,621,48,478,143,110,101,9,65,36,Greater MN,2022-07-14
2022-01-14,Metro,4009,3830,179,2913,917,818,753,65,610,143,Metro,2022-07-14
2022-01-14,Northeast,758,499,259,420,79,112,89,23,65,24,Greater MN,2022-07-14
2022-01-14,Northwest,256,167,89,144,23,24,18,6,13,5,Greater MN,2022-07-14
2022-01-14,South Central,318,226,92,184,42,22,12,10,8,4,Greater MN,2022-07-14
2022-01-14,Southeast,1289,1096,193,967,129,251,187,64,152,35,Greater MN,2022-07-14
2022-01-14,Southwest,338,134,204,103,31,11,5,6,3,2,Greater MN,2022-07-14
2022-01-14,State,7784,6664,1120,5285,1379,1360,1171,189,921,250,State,2022-07-14
2022-01-14,West Central,147,91,56,76,15,12,6,6,5,1,Greater MN,2022-07-14
2021-01-15,Central,866,652,214,590,62,99,53,46,45,8,Greater MN,2022-07-14
2021-01-15,Metro,3861,3515,346,3232,283,850,698,152,610,88,Metro,2022-07-14
2021-01-15,Northeast,966,494,472,449,45,114,76,38,67,9,Greater MN,2022-07-14
2021-01-15,Northwest,327,142,185,130,12,29,12,17,7,5,Greater MN,2022-07-14
2021-01-15,South Central,409,208,201,188,20,25,11,14,11,0,Greater MN,2022-07-14
2021-01-15,Southeast,1373,968,405,908,60,258,160,98,148,12,Greater MN,2022-07-14
2021-01-15,Southwest,366,126,240,114,12,14,3,11,2,1,Greater MN,2022-07-14
2021-01-15,State,8373,6198,2175,5694,504,1409,1024,385,899,125,State,2022-07-14
2021-01-15,West Central,205,93,112,83,10,20,11,9,9,2,Greater MN,2022-07-14
2022-01-15,Central,659,597,62,445,152,106,95,11,63,32,Greater MN,2022-07-14
2022-01-15,Metro,3933,3768,165,2883,885,818,753,65,611,142,Metro,2022-07-14
2022-01-15,Northeast,775,480,295,402,78,112,91,21,72,19,Greater MN,2022-07-14
2022-01-15,Northwest,254,154,100,134,20,25,17,8,12,5,Greater MN,2022-07-14
2022-01-15,South Central,311,221,90,176,45,21,10,11,7,3,Greater MN,2022-07-14
2022-01-15,Southeast,1287,1061,226,933,128,249,191,58,164,27,Greater MN,2022-07-14
2022-01-15,Southwest,336,125,211,98,27,13,7,6,4,3,Greater MN,2022-07-14
2022-01-15,State,7705,6501,1204,5150,1351,1355,1169,186,936,233,State,2022-07-14
2022-01-15,West Central,150,95,55,79,16,11,5,6,3,2,Greater MN,2022-07-14
2021-01-16,Central,828,601,227,544,57,105,67,38,57,10,Greater MN,2022-07-14
2021-01-16,Metro,3875,3396,479,3115,281,838,698,140,616,82,Metro,2022-07-14
2021-01-16,Northeast,967,484,483,447,37,114,71,43,62,9,Greater MN,2022-07-14
2021-01-16,Northwest,328,148,180,134,14,29,14,15,10,4,Greater MN,2022-07-14
2021-01-16,South Central,413,218,195,194,24,24,9,15,9,0,Greater MN,2022-07-14
2021-01-16,Southeast,1370,943,427,891,52,258,168,90,156,12,Greater MN,2022-07-14
2021-01-16,Southwest,371,128,243,117,11,14,4,10,2,2,Greater MN,2022-07-14
2021-01-16,State,8357,6001,2356,5514,487,1402,1039,363,920,119,State,2022-07-14
2021-01-16,West Central,205,83,122,72,11,20,8,12,8,0,Greater MN,2022-07-14
2022-01-16,Central,663,598,65,440,158,113,100,13,69,31,Greater MN,2022-07-14
2022-01-16,Metro,3861,3653,208,2786,867,812,734,78,589,145,Metro,2022-07-14
2022-01-16,Northeast,764,464,300,389,75,112,83,29,65,18,Greater MN,2022-07-14
2022-01-16,Northwest,254,146,108,124,22,25,18,7,13,5,Greater MN,2022-07-14
2022-01-16,South Central,315,224,91,178,46,21,10,11,7,3,Greater MN,2022-07-14
2022-01-16,Southeast,1284,1006,278,886,120,250,170,80,143,27,Greater MN,2022-07-14
2022-01-16,Southwest,334,107,227,81,26,13,8,5,6,2,Greater MN,2022-07-14
2022-01-16,State,7619,6278,1341,4954,1324,1357,1127,230,895,232,State,2022-07-14
2022-01-16,West Central,144,80,64,70,10,11,4,7,3,1,Greater MN,2022-07-14
2021-01-17,Central,804,539,265,489,50,108,65,43,55,10,Greater MN,2022-07-14
2021-01-17,Metro,3756,3211,545,2933,278,824,686,138,601,85,Metro,2022-07-14
2021-01-17,Northeast,966,487,479,443,44,114,60,54,53,7,Greater MN,2022-07-14
2021-01-17,Northwest,327,145,182,132,13,29,14,15,11,3,Greater MN,2022-07-14
2021-01-17,South Central,399,184,215,164,20,25,9,16,9,0,Greater MN,2022-07-14
2021-01-17,Southeast,1373,875,498,828,47,257,152,105,140,12,Greater MN,2022-07-14
2021-01-17,Southwest,379,127,252,117,10,14,3,11,1,2,Greater MN,2022-07-14
2021-01-17,State,8209,5633,2576,5162,471,1391,998,393,879,119,State,2022-07-14
2021-01-17,West Central,205,65,140,56,9,20,9,11,9,0,Greater MN,2022-07-14
2022-01-17,Central,653,602,51,449,153,107,95,12,63,32,Greater MN,2022-07-14
2022-01-17,Metro,3852,3618,234,2713,905,802,725,77,577,148,Metro,2022-07-14
2022-01-17,Northeast,766,484,282,397,87,110,85,25,63,22,Greater MN,2022-07-14
2022-01-17,Northwest,256,159,97,138,21,26,18,8,10,8,Greater MN,2022-07-14
2022-01-17,South Central,326,239,87,190,49,22,10,12,7,3,Greater MN,2022-07-14
2022-01-17,Southeast,1279,982,297,878,104,245,165,80,134,31,Greater MN,2022-07-14
2022-01-17,Southwest,333,133,200,105,28,12,6,6,3,3,Greater MN,2022-07-14
2022-01-17,State,7608,6308,1300,4946,1362,1335,1108,227,860,248,State,2022-07-14
2022-01-17,West Central,143,91,52,76,15,11,4,7,3,1,Greater MN,2022-07-14
2021-01-18,Central,810,557,253,501,56,100,57,43,48,9,Greater MN,2022-07-14
2021-01-18,Metro,3711,3246,465,2965,281,826,673,153,594,79,Metro,2022-07-14
2021-01-18,Northeast,968,475,493,436,39,114,71,43,63,8,Greater MN,2022-07-14
2021-01-18,Northwest,328,148,180,135,13,29,12,17,10,2,Greater MN,2022-07-14
2021-01-18,South Central,390,195,195,175,20,26,11,15,11,0,Greater MN,2022-07-14
2021-01-18,Southeast,1367,868,499,825,43,256,140,116,132,8,Greater MN,2022-07-14
2021-01-18,Southwest,370,122,248,109,13,15,4,11,0,4,Greater MN,2022-07-14
2021-01-18,State,8149,5681,2468,5209,472,1386,976,410,866,110,State,2022-07-14
2021-01-18,West Central,205,70,135,63,7,20,8,12,8,0,Greater MN,2022-07-14
2022-01-18,Central,679,634,45,485,149,111,97,14,65,32,Greater MN,2022-07-14
2022-01-18,Metro,3907,3720,187,2820,900,819,743,76,600,143,Metro,2022-07-14
2022-01-18,Northeast,728,493,235,400,93,110,83,27,63,20,Greater MN,2022-07-14
2022-01-18,Northwest,248,161,87,137,24,31,23,8,14,9,Greater MN,2022-07-14
2022-01-18,South Central,324,237,87,200,37,22,10,12,8,2,Greater MN,2022-07-14
2022-01-18,Southeast,1293,1048,245,935,113,249,179,70,149,30,Greater MN,2022-07-14
2022-01-18,Southwest,334,141,193,113,28,13,8,5,5,3,Greater MN,2022-07-14
2022-01-18,State,7655,6532,1123,5176,1356,1366,1148,218,908,240,State,2022-07-14
2022-01-18,West Central,142,98,44,86,12,11,5,6,4,1,Greater MN,2022-07-14
2021-01-19,Central,841,607,234,561,46,100,68,32,56,12,Greater MN,2022-07-14
2021-01-19,Metro,3999,3513,486,3228,285,846,708,138,630,78,Metro,2022-07-14
2021-01-19,Northeast,966,493,473,457,36,114,73,41,68,5,Greater MN,2022-07-14
2021-01-19,Northwest,327,140,187,129,11,29,13,16,11,2,Greater MN,2022-07-14
2021-01-19,South Central,414,215,199,196,19,24,8,16,8,0,Greater MN,2022-07-14
2021-01-19,Southeast,1367,919,448,877,42,257,163,94,152,11,Greater MN,2022-07-14
2021-01-19,Southwest,371,121,250,104,17,14,2,12,0,2,Greater MN,2022-07-14
2021-01-19,State,8490,6085,2405,5622,463,1404,1047,357,936,111,State,2022-07-14
2021-01-19,West Central,205,77,128,70,7,20,12,8,11,1,Greater MN,2022-07-14
2022-01-19,Central,723,674,49,522,152,114,99,15,67,32,Greater MN,2022-07-14
2022-01-19,Metro,4202,3935,267,3020,915,830,756,74,615,141,Metro,2022-07-14
2022-01-19,Northeast,743,531,212,433,98,110,87,23,63,24,Greater MN,2022-07-14
2022-01-19,Northwest,264,177,87,150,27,25,17,8,9,8,Greater MN,2022-07-14
2022-01-19,South Central,321,241,80,196,45,22,10,12,7,3,Greater MN,2022-07-14
2022-01-19,Southeast,1310,1092,218,979,113,251,185,66,152,33,Greater MN,2022-07-14
2022-01-19,Southwest,342,143,199,118,25,14,9,5,5,4,Greater MN,2022-07-14
2022-01-19,State,8081,6923,1158,5537,1386,1379,1170,209,923,247,State,2022-07-14
2022-01-19,West Central,176,130,46,119,11,13,7,6,5,2,Greater MN,2022-07-14
2021-01-20,Central,893,654,239,604,50,94,62,32,49,13,Greater MN,2022-07-14
2021-01-20,Metro,4056,3553,503,3274,279,829,682,147,612,70,Metro,2022-07-14
2021-01-20,Northeast,980,518,462,480,38,114,73,41,69,4,Greater MN,2022-07-14
2021-01-20,Northwest,344,161,183,151,10,29,13,16,11,2,Greater MN,2022-07-14
2021-01-20,South Central,412,214,198,200,14,25,12,13,11,1,Greater MN,2022-07-14
2021-01-20,Southeast,1387,975,412,927,48,256,166,90,159,7,Greater MN,2022-07-14
2021-01-20,Southwest,390,144,246,125,19,14,2,12,1,1,Greater MN,2022-07-14
2021-01-20,State,8699,6335,2364,5872,463,1381,1019,362,921,98,State,2022-07-14
2021-01-20,West Central,237,116,121,111,5,20,9,11,9,0,Greater MN,2022-07-14
2022-01-20,Central,688,625,63,479,146,114,99,15,66,33,Greater MN,2022-07-14
2022-01-20,Metro,3961,3770,191,2886,884,819,770,49,633,137,Metro,2022-07-14
2022-01-20,Northeast,736,523,213,436,87,110,84,26,60,24,Greater MN,2022-07-14
2022-01-20,Northwest,250,171,79,147,24,23,16,7,8,8,Greater MN,2022-07-14
2022-01-20,South Central,321,230,91,190,40,22,11,11,6,5,Greater MN,2022-07-14
2022-01-20,Southeast,1295,1077,218,962,115,249,195,54,168,27,Greater MN,2022-07-14
2022-01-20,Southwest,332,128,204,101,27,14,9,5,6,3,Greater MN,2022-07-14
2022-01-20,State,7723,6616,1107,5282,1334,1363,1191,172,950,241,State,2022-07-14
2022-01-20,West Central,140,92,48,81,11,12,7,5,3,4,Greater MN,2022-07-14
2021-01-21,Central,856,623,233,577,46,95,65,30,54,11,Greater MN,2022-07-14
2021-01-21,Metro,3821,3431,390,3176,255,847,687,160,609,78,Metro,2022-07-14
2021-01-21,Northeast,958,529,429,494,35,114,70,44,64,6,Greater MN,2022-07-14
2021-01-21,Northwest,328,145,183,132,13,29,8,21,8,0,Greater MN,2022-07-14
2021-01-21,South Central,409,227,182,212,15,24,9,15,8,1,Greater MN,2022-07-14
2021-01-21,Southeast,1375,986,389,935,51,258,166,92,158,8,Greater MN,2022-07-14
2021-01-21,Southwest,375,158,217,138,20,14,3,11,3,0,Greater MN,2022-07-14
2021-01-21,State,8327,6202,2125,5761,441,1401,1017,384,913,104,State,2022-07-14
2021-01-21,West Central,205,103,102,97,6,20,9,11,9,0,Greater MN,2022-07-14
2022-01-21,Central,696,632,64,484,148,107,94,13,61,33,Greater MN,2022-07-14
2022-01-21,Metro,3944,3773,171,2911,862,826,758,68,622,136,Metro,2022-07-14
2022-01-21,Northeast,764,516,248,422,94,110,84,26,63,21,Greater MN,2022-07-14
2022-01-21,Northwest,247,165,82,137,28,22,17,5,7,10,Greater MN,2022-07-14
2022-01-21,South Central,315,234,81,194,40,22,11,11,6,5,Greater MN,2022-07-14
2022-01-21,Southeast,1295,1067,228,952,115,249,188,61,158,30,Greater MN,2022-07-14
2022-01-21,Southwest,338,131,207,98,33,15,8,7,7,1,Greater MN,2022-07-14
2022-01-21,State,7746,6602,1144,5274,1328,1363,1164,199,926,238,State,2022-07-14
2022-01-21,West Central,147,84,63,76,8,12,4,8,2,2,Greater MN,2022-07-14
2021-01-22,Central,838,603,235,558,45,99,63,36,51,12,Greater MN,2022-07-14
2021-01-22,Metro,3819,3478,341,3219,259,859,711,148,624,87,Metro,2022-07-14
2021-01-22,Northeast,965,529,436,498,31,114,72,42,69,3,Greater MN,2022-07-14
2021-01-22,Northwest,328,149,179,136,13,29,9,20,7,2,Greater MN,2022-07-14
2021-01-22,South Central,410,210,200,199,11,25,11,14,10,1,Greater MN,2022-07-14
2021-01-22,Southeast,1378,1006,372,954,52,257,165,92,158,7,Greater MN,2022-07-14
2021-01-22,Southwest,377,154,223,136,18,15,3,12,3,0,Greater MN,2022-07-14
2021-01-22,State,8320,6216,2104,5781,435,1418,1041,377,929,112,State,2022-07-14
2021-01-22,West Central,205,87,118,81,6,20,7,13,7,0,Greater MN,2022-07-14
2022-01-22,Central,662,597,65,450,147,105,94,11,58,36,Greater MN,2022-07-14
2022-01-22,Metro,3888,3598,290,2748,850,815,732,83,607,125,Metro,2022-07-14
2022-01-22,Northeast,754,498,256,410,88,114,90,24,62,28,Greater MN,2022-07-14
2022-01-22,Northwest,244,153,91,127,26,22,13,9,5,8,Greater MN,2022-07-14
2022-01-22,South Central,319,218,101,179,39,22,10,12,5,5,Greater MN,2022-07-14
2022-01-22,Southeast,1298,1015,283,910,105,250,192,58,161,31,Greater MN,2022-07-14
2022-01-22,Southwest,338,135,203,104,31,14,6,8,5,1,Greater MN,2022-07-14
2022-01-22,State,7646,6289,1357,4991,1298,1355,1145,210,908,237,State,2022-07-14
2022-01-22,West Central,143,75,68,63,12,13,8,5,5,3,Greater MN,2022-07-14
2021-01-23,Central,838,600,238,564,36,96,63,33,53,10,Greater MN,2022-07-14
2021-01-23,Metro,3752,3330,422,3074,256,851,695,156,615,80,Metro,2022-07-14
2021-01-23,Northeast,965,484,481,460,24,114,72,42,69,3,Greater MN,2022-07-14
2021-01-23,Northwest,330,154,176,142,12,29,13,16,10,3,Greater MN,2022-07-14
2021-01-23,South Central,408,206,202,195,11,25,10,15,10,0,Greater MN,2022-07-14
2021-01-23,Southeast,1372,975,397,930,45,258,157,101,150,7,Greater MN,2022-07-14
2021-01-23,Southwest,362,123,239,109,14,15,2,13,2,0,Greater MN,2022-07-14
2021-01-23,State,8232,5941,2291,5536,405,1408,1016,392,913,103,State,2022-07-14
2021-01-23,West Central,205,69,136,62,7,20,4,16,4,0,Greater MN,2022-07-14
2022-01-23,Central,658,603,55,465,138,106,96,10,65,31,Greater MN,2022-07-14
2022-01-23,Metro,3909,3657,252,2812,845,810,732,78,606,126,Metro,2022-07-14
2022-01-23,Northeast,753,485,268,396,89,112,80,32,54,26,Greater MN,2022-07-14
2022-01-23,Northwest,243,142,101,116,26,24,12,12,5,7,Greater MN,2022-07-14
2022-01-23,South Central,317,216,101,180,36,22,11,11,7,4,Greater MN,2022-07-14
2022-01-23,Southeast,1295,963,332,858,105,251,173,78,144,29,Greater MN,2022-07-14
2022-01-23,Southwest,329,125,204,98,27,14,6,8,5,1,Greater MN,2022-07-14
2022-01-23,State,7645,6261,1384,4984,1277,1351,1116,235,889,227,State,2022-07-14
2022-01-23,West Central,141,70,71,59,11,12,6,6,3,3,Greater MN,2022-07-14
2021-01-24,Central,813,574,239,529,45,96,62,34,53,9,Greater MN,2022-07-14
2021-01-24,Metro,3673,3118,555,2860,258,814,652,162,576,76,Metro,2022-07-14
2021-01-24,Northeast,963,482,481,458,24,114,58,56,55,3,Greater MN,2022-07-14
2021-01-24,Northwest,328,148,180,136,12,29,11,18,8,3,Greater MN,2022-07-14
2021-01-24,South Central,409,203,206,192,11,24,9,15,9,0,Greater MN,2022-07-14
2021-01-24,Southeast,1364,876,488,832,44,254,134,120,126,8,Greater MN,2022-07-14
2021-01-24,Southwest,357,121,236,108,13,14,1,13,1,0,Greater MN,2022-07-14
2021-01-24,State,8112,5583,2529,5171,412,1365,929,436,830,99,State,2022-07-14
2021-01-24,West Central,205,61,144,56,5,20,2,18,2,0,Greater MN,2022-07-14
2022-01-24,Central,657,602,55,477,125,106,94,12,63,31,Greater MN,2022-07-14
2022-01-24,Metro,3814,3643,171,2783,860,822,727,95,602,125,Metro,2022-07-14
2022-01-24,Northeast,754,481,273,390,91,112,81,31,58,23,Greater MN,2022-07-14
2022-01-24,Northwest,244,138,106,111,27,24,13,11,7,6,Greater MN,2022-07-14
2022-01-24,South Central,319,234,85,194,40,22,9,13,5,4,Greater MN,2022-07-14
2022-01-24,Southeast,1283,956,327,841,115,248,175,73,143,32,Greater MN,2022-07-14
2022-01-24,Southwest,339,119,220,93,26,12,4,8,3,1,Greater MN,2022-07-14
2022-01-24,State,7547,6241,1306,4950,1291,1361,1112,249,887,225,State,2022-07-14
2022-01-24,West Central,137,68,69,61,7,15,9,6,6,3,Greater MN,2022-07-14
2021-01-25,Central,793,551,242,507,44,102,71,31,61,10,Greater MN,2022-07-14
2021-01-25,Metro,3650,3093,557,2850,243,814,649,165,575,74,Metro,2022-07-14
2021-01-25,Northeast,963,485,478,459,26,114,61,53,58,3,Greater MN,2022-07-14
2021-01-25,Northwest,329,150,179,140,10,29,10,19,7,3,Greater MN,2022-07-14
2021-01-25,South Central,409,210,199,197,13,24,9,15,8,1,Greater MN,2022-07-14
2021-01-25,Southeast,1352,835,517,793,42,254,133,121,124,9,Greater MN,2022-07-14
2021-01-25,Southwest,361,134,227,121,13,14,1,13,1,0,Greater MN,2022-07-14
2021-01-25,State,8062,5535,2527,5138,397,1371,935,436,835,100,State,2022-07-14
2021-01-25,West Central,205,77,128,71,6,20,1,19,1,0,Greater MN,2022-07-14
2022-01-25,Central,670,627,43,498,129,109,98,11,66,32,Greater MN,2022-07-14
2022-01-25,Metro,3961,3791,170,2930,861,798,729,69,605,124,Metro,2022-07-14
2022-01-25,Northeast,750,515,235,420,95,112,89,23,64,25,Greater MN,2022-07-14
2022-01-25,Northwest,249,138,111,106,32,24,13,11,7,6,Greater MN,2022-07-14
2022-01-25,South Central,321,234,87,183,51,22,9,13,5,4,Greater MN,2022-07-14
2022-01-25,Southeast,1303,1040,263,915,125,249,185,64,155,30,Greater MN,2022-07-14
2022-01-25,Southwest,353,146,207,117,29,11,4,7,2,2,Greater MN,2022-07-14
2022-01-25,State,7743,6583,1160,5251,1332,1338,1133,205,906,227,State,2022-07-14
2022-01-25,West Central,136,92,44,82,10,13,6,7,2,4,Greater MN,2022-07-14
2021-01-26,Central,854,625,229,585,40,107,77,30,67,10,Greater MN,2022-07-14
2021-01-26,Metro,3821,3303,518,3067,236,844,659,185,589,70,Metro,2022-07-14
2021-01-26,Northeast,957,505,452,484,21,114,72,42,68,4,Greater MN,2022-07-14
2021-01-26,Northwest,329,166,163,157,9,29,12,17,8,4,Greater MN,2022-07-14
2021-01-26,South Central,411,227,184,216,11,24,12,12,12,0,Greater MN,2022-07-14
2021-01-26,Southeast,1359,916,443,871,45,254,142,112,134,8,Greater MN,2022-07-14
2021-01-26,Southwest,374,150,224,136,14,13,3,10,1,2,Greater MN,2022-07-14
2021-01-26,State,8310,5984,2326,5603,381,1405,983,422,884,99,State,2022-07-14
2021-01-26,West Central,205,92,113,87,5,20,6,14,5,1,Greater MN,2022-07-14
2022-01-26,Central,690,627,63,504,123,112,98,14,66,32,Greater MN,2022-07-14
2022-01-26,Metro,4200,3968,232,3126,842,811,742,69,615,127,Metro,2022-07-14
2022-01-26,Northeast,758,542,216,441,101,112,89,23,65,24,Greater MN,2022-07-14
2022-01-26,Northwest,262,152,110,126,26,24,15,9,7,8,Greater MN,2022-07-14
2022-01-26,South Central,320,241,79,183,58,22,12,10,10,2,Greater MN,2022-07-14
2022-01-26,Southeast,1295,1062,233,935,127,250,190,60,159,31,Greater MN,2022-07-14
2022-01-26,Southwest,296,144,152,116,28,13,7,6,4,3,Greater MN,2022-07-14
2022-01-26,State,7994,6865,1129,5550,1315,1357,1159,198,927,232,State,2022-07-14
2022-01-26,West Central,173,129,44,119,10,13,6,7,1,5,Greater MN,2022-07-14
2021-01-27,Central,884,649,235,623,26,107,72,35,61,11,Greater MN,2022-07-14
2021-01-27,Metro,4032,3592,440,3366,226,824,660,164,590,70,Metro,2022-07-14
2021-01-27,Northeast,963,531,432,514,17,114,65,49,61,4,Greater MN,2022-07-14
2021-01-27,Northwest,345,187,158,179,8,29,14,15,10,4,Greater MN,2022-07-14
2021-01-27,South Central,407,218,189,208,10,24,8,16,7,1,Greater MN,2022-07-14
2021-01-27,Southeast,1368,951,417,909,42,255,145,110,138,7,Greater MN,2022-07-14
2021-01-27,Southwest,392,163,229,149,14,14,2,12,2,0,Greater MN,2022-07-14
2021-01-27,State,8628,6403,2225,6059,344,1387,974,413,876,98,State,2022-07-14
2021-01-27,West Central,237,112,125,111,1,20,8,12,7,1,Greater MN,2022-07-14
2022-01-27,Central,672,616,56,482,134,100,85,15,56,29,Greater MN,2022-07-14
2022-01-27,Metro,4049,3827,222,3007,820,823,757,66,645,112,Metro,2022-07-14
2022-01-27,Northeast,755,533,222,437,96,112,88,24,63,25,Greater MN,2022-07-14
2022-01-27,Northwest,246,149,97,123,26,24,13,11,8,5,Greater MN,2022-07-14
2022-01-27,South Central,319,233,86,184,49,22,11,11,8,3,Greater MN,2022-07-14
2022-01-27,Southeast,1284,1064,220,953,111,250,193,57,162,31,Greater MN,2022-07-14
2022-01-27,Southwest,280,133,147,102,31,13,6,7,3,3,Greater MN,2022-07-14
2022-01-27,State,7749,6661,1088,5381,1280,1356,1159,197,946,213,State,2022-07-14
2022-01-27,West Central,144,106,38,93,13,12,6,6,1,5,Greater MN,2022-07-14
2021-01-28,Central,859,637,222,610,27,104,69,35,60,9,Greater MN,2022-07-14
2021-01-28,Metro,3894,3435,459,3198,237,833,657,176,587,70,Metro,2022-07-14
2021-01-28,Northeast,962,527,435,507,20,114,68,46,65,3,Greater MN,2022-07-14
2021-01-28,Northwest,328,180,148,172,8,29,14,15,9,5,Greater MN,2022-07-14
2021-01-28,South Central,410,219,191,204,15,26,11,15,11,0,Greater MN,2022-07-14
2021-01-28,Southeast,1360,936,424,901,35,259,152,107,145,7,Greater MN,2022-07-14
2021-01-28,Southwest,354,148,206,136,12,11,3,8,3,0,Greater MN,2022-07-14
2021-01-28,State,8372,6167,2205,5812,355,1396,982,414,887,95,State,2022-07-14
2021-01-28,West Central,205,85,120,84,1,20,8,12,7,1,Greater MN,2022-07-14
2022-01-28,Central,689,616,73,482,134,103,91,12,61,30,Greater MN,2022-07-14
2022-01-28,Metro,4106,3811,295,3020,791,818,744,74,627,117,Metro,2022-07-14
2022-01-28,Northeast,760,535,225,430,105,112,83,29,59,24,Greater MN,2022-07-14
2022-01-28,Northwest,247,141,106,121,20,24,17,7,11,6,Greater MN,2022-07-14
2022-01-28,South Central,315,219,96,170,49,22,13,9,9,4,Greater MN,2022-07-14
2022-01-28,Southeast,1289,1087,202,975,112,250,189,61,162,27,Greater MN,2022-07-14
2022-01-28,Southwest,293,138,155,109,29,11,5,6,2,3,Greater MN,2022-07-14
2022-01-28,State,7844,6658,1186,5402,1256,1351,1148,203,934,214,State,2022-07-14
2022-01-28,West Central,145,111,34,95,16,11,6,5,3,3,Greater MN,2022-07-14
2021-01-29,Central,839,588,251,568,20,102,71,31,62,9,Greater MN,2022-07-14
2021-01-29,Metro,3862,3378,484,3154,224,826,655,171,591,64,Metro,2022-07-14
2021-01-29,Northeast,963,529,434,510,19,114,67,47,62,5,Greater MN,2022-07-14
2021-01-29,Northwest,328,164,164,154,10,29,7,22,4,3,Greater MN,2022-07-14
2021-01-29,South Central,376,210,166,195,15,26,9,17,9,0,Greater MN,2022-07-14
2021-01-29,Southeast,1285,966,319,931,35,256,160,96,154,6,Greater MN,2022-07-14
2021-01-29,Southwest,356,128,228,118,10,15,0,15,0,0,Greater MN,2022-07-14
2021-01-29,State,8214,6030,2184,5696,334,1388,975,413,887,88,State,2022-07-14
2021-01-29,West Central,205,67,138,66,1,20,6,14,5,1,Greater MN,2022-07-14
2022-01-29,Central,637,558,79,431,127,97,84,13,56,28,Greater MN,2022-07-14
2022-01-29,Metro,3953,3743,210,2989,754,816,732,84,626,106,Metro,2022-07-14
2022-01-29,Northeast,744,517,227,410,107,111,88,23,65,23,Greater MN,2022-07-14
2022-01-29,Northwest,246,121,125,99,22,23,13,10,5,8,Greater MN,2022-07-14
2022-01-29,South Central,311,210,101,170,40,22,9,13,6,3,Greater MN,2022-07-14
2022-01-29,Southeast,1288,1049,239,947,102,252,179,73,152,27,Greater MN,2022-07-14
2022-01-29,Southwest,287,117,170,89,28,11,4,7,2,2,Greater MN,2022-07-14
2022-01-29,State,7610,6401,1209,5207,1194,1341,1114,227,916,198,State,2022-07-14
2022-01-29,West Central,144,86,58,72,14,9,5,4,4,1,Greater MN,2022-07-14
2021-01-30,Central,846,586,260,564,22,105,74,31,65,9,Greater MN,2022-07-14
2021-01-30,Metro,3748,3223,525,3020,203,817,658,159,600,58,Metro,2022-07-14
2021-01-30,Northeast,963,493,470,478,15,113,69,44,65,4,Greater MN,2022-07-14
2021-01-30,Northwest,328,142,186,134,8,29,10,19,6,4,Greater MN,2022-07-14
2021-01-30,South Central,373,180,193,169,11,26,9,17,8,1,Greater MN,2022-07-14
2021-01-30,Southeast,1283,934,349,899,35,250,150,100,141,9,Greater MN,2022-07-14
2021-01-30,Southwest,365,121,244,115,6,14,1,13,1,0,Greater MN,2022-07-14
2021-01-30,State,8111,5747,2364,5446,301,1374,981,393,895,86,State,2022-07-14
2021-01-30,West Central,205,68,137,67,1,20,10,10,9,1,Greater MN,2022-07-14
2022-01-30,Central,656,565,91,429,136,98,83,15,57,26,Greater MN,2022-07-14
2022-01-30,Metro,3864,3667,197,2910,757,808,723,85,624,99,Metro,2022-07-14
2022-01-30,Northeast,747,499,248,398,101,112,87,25,60,27,Greater MN,2022-07-14
2022-01-30,Northwest,246,140,106,118,22,23,12,11,5,7,Greater MN,2022-07-14
2022-01-30,South Central,312,208,104,166,42,22,9,13,8,1,Greater MN,2022-07-14
2022-01-30,Southeast,1290,966,324,864,102,252,169,83,138,31,Greater MN,2022-07-14
2022-01-30,Southwest,282,112,170,89,23,12,5,7,3,2,Greater MN,2022-07-14
2022-01-30,State,7536,6240,1296,5042,1198,1338,1094,244,900,194,State,2022-07-14
2022-01-30,West Central,139,83,56,68,15,11,6,5,5,1,Greater MN,2022-07-14
2021-01-31,Central,816,539,277,518,21,101,70,31,61,9,Greater MN,2022-07-14
2021-01-31,Metro,3566,3053,513,2855,198,809,634,175,573,61,Metro,2022-07-14
2021-01-31,Northeast,960,477,483,463,14,114,72,42,67,5,Greater MN,2022-07-14
2021-01-31,Northwest,328,134,194,127,7,29,15,14,10,5,Greater MN,2022-07-14
2021-01-31,South Central,371,194,177,180,14,24,9,15,8,1,Greater MN,2022-07-14
2021-01-31,Southeast,1281,847,434,812,35,251,128,123,118,10,Greater MN,2022-07-14
2021-01-31,Southwest,352,112,240,107,5,14,1,13,1,0,Greater MN,2022-07-14
2021-01-31,State,7879,5417,2462,5122,295,1362,937,425,845,92,State,2022-07-14
2021-01-31,West Central,205,61,144,60,1,20,8,12,7,1,Greater MN,2022-07-14
2022-01-31,Central,663,583,80,456,127,95,81,14,56,25,Greater MN,2022-07-14
2022-01-31,Metro,3844,3597,247,2854,743,799,703,96,604,99,Metro,2022-07-14
2022-01-31,Northeast,746,512,234,419,93,112,85,27,60,25,Greater MN,2022-07-14
2022-01-31,Northwest,250,142,108,119,23,22,14,8,7,7,Greater MN,2022-07-14
2022-01-31,South Central,311,208,103,163,45,23,11,12,8,3,Greater MN,2022-07-14
2022-01-31,Southeast,1287,960,327,855,105,252,164,88,133,31,Greater MN,2022-07-14
2022-01-31,Southwest,288,117,171,92,25,13,6,7,5,1,Greater MN,2022-07-14
2022-01-31,State,7530,6212,1318,5034,1178,1328,1070,258,877,193,State,2022-07-14
2022-01-31,West Central,141,93,48,76,17,12,6,6,4,2,Greater MN,2022-07-14
2021-02-01,Central,812,555,257,532,23,96,60,36,52,8,Greater MN,2022-07-14
2021-02-01,Metro,3522,3032,490,2835,197,811,651,160,595,56,Metro,2022-07-14
2021-02-01,Northeast,943,478,465,463,15,114,72,42,68,4,Greater MN,2022-07-14
2021-02-01,Northwest,328,124,204,116,8,29,17,12,13,4,Greater MN,2022-07-14
2021-02-01,South Central,381,205,176,189,16,24,8,16,7,1,Greater MN,2022-07-14
2021-02-01,Southeast,1287,852,435,810,42,250,138,112,128,10,Greater MN,2022-07-14
2021-02-01,Southwest,351,111,240,105,6,15,2,13,2,0,Greater MN,2022-07-14
2021-02-01,State,7829,5422,2407,5112,310,1359,958,401,874,84,State,2022-07-14
2021-02-01,West Central,205,65,140,62,3,20,10,10,9,1,Greater MN,2022-07-14
2022-02-01,Central,696,622,74,499,123,100,87,13,63,24,Greater MN,2022-07-14
2022-02-01,Metro,3917,3711,206,2983,728,813,723,90,611,112,Metro,2022-07-14
2022-02-01,Northeast,756,539,217,455,84,99,82,17,56,26,Greater MN,2022-07-14
2022-02-01,Northwest,249,155,94,123,32,23,15,8,8,7,Greater MN,2022-07-14
2022-02-01,South Central,311,216,95,171,45,22,9,13,7,2,Greater MN,2022-07-14
2022-02-01,Southeast,1298,1046,252,943,103,255,182,73,151,31,Greater MN,2022-07-14
2022-02-01,Southwest,306,148,158,122,26,12,5,7,3,2,Greater MN,2022-07-14
2022-02-01,State,7675,6532,1143,5374,1158,1337,1109,228,904,205,State,2022-07-14
2022-02-01,West Central,142,95,47,78,17,13,6,7,5,1,Greater MN,2022-07-14
2021-02-02,Central,826,579,247,559,20,102,71,31,64,7,Greater MN,2022-07-14
2021-02-02,Metro,3722,3332,390,3123,209,819,641,178,592,49,Metro,2022-07-14
2021-02-02,Northeast,949,493,456,481,12,113,76,37,72,4,Greater MN,2022-07-14
2021-02-02,Northwest,329,148,181,142,6,29,14,15,11,3,Greater MN,2022-07-14
2021-02-02,South Central,383,227,156,215,12,24,7,17,6,1,Greater MN,2022-07-14
2021-02-02,Southeast,1285,896,389,863,33,258,147,111,136,11,Greater MN,2022-07-14
2021-02-02,Southwest,358,113,245,106,7,16,3,13,2,1,Greater MN,2022-07-14
2021-02-02,State,8057,5852,2205,5550,302,1381,967,414,890,77,State,2022-07-14
2021-02-02,West Central,205,64,141,61,3,20,8,12,7,1,Greater MN,2022-07-14
2022-02-02,Central,743,664,79,536,128,100,88,12,66,22,Greater MN,2022-07-14
2022-02-02,Metro,4138,3913,225,3210,703,839,730,109,612,118,Metro,2022-07-14
2022-02-02,Northeast,761,584,177,493,91,98,82,16,57,25,Greater MN,2022-07-14
2022-02-02,Northwest,251,163,88,132,31,25,12,13,5,7,Greater MN,2022-07-14
2022-02-02,South Central,311,227,84,183,44,30,18,12,15,3,Greater MN,2022-07-14
2022-02-02,Southeast,1310,1085,225,979,106,253,186,67,161,25,Greater MN,2022-07-14
2022-02-02,Southwest,327,148,179,118,30,13,6,7,4,2,Greater MN,2022-07-14
2022-02-02,State,8017,6910,1107,5758,1152,1371,1129,242,926,203,State,2022-07-14
2022-02-02,West Central,176,126,50,107,19,13,7,6,6,1,Greater MN,2022-07-14
2021-02-03,Central,869,632,237,612,20,103,71,32,65,6,Greater MN,2022-07-14
2021-02-03,Metro,3970,3612,358,3417,195,803,626,177,573,53,Metro,2022-07-14
2021-02-03,Northeast,953,537,416,523,14,113,78,35,73,5,Greater MN,2022-07-14
2021-02-03,Northwest,345,182,163,174,8,29,17,12,13,4,Greater MN,2022-07-14
2021-02-03,South Central,383,221,162,210,11,25,9,16,8,1,Greater MN,2022-07-14
2021-02-03,Southeast,1301,966,335,934,32,259,155,104,143,12,Greater MN,2022-07-14
2021-02-03,Southwest,384,138,246,133,5,14,2,12,2,0,Greater MN,2022-07-14
2021-02-03,State,8445,6398,2047,6110,288,1366,964,402,882,82,State,2022-07-14
2021-02-03,West Central,240,110,130,107,3,20,6,14,5,1,Greater MN,2022-07-14
2022-02-03,Central,689,611,78,484,127,99,83,16,63,20,Greater MN,2022-07-14
2022-02-03,Metro,4009,3793,216,3131,662,814,707,107,589,118,Metro,2022-07-14
2022-02-03,Northeast,749,562,187,492,70,97,82,15,57,25,Greater MN,2022-07-14
2022-02-03,Northwest,258,151,107,125,26,25,15,10,8,7,Greater MN,2022-07-14
2022-02-03,South Central,309,223,86,186,37,29,16,13,11,5,Greater MN,2022-07-14
2022-02-03,Southeast,1302,1055,247,956,99,255,186,69,163,23,Greater MN,2022-07-14
2022-02-03,Southwest,323,139,184,115,24,13,5,8,3,2,Greater MN,2022-07-14
2022-02-03,State,7783,6616,1167,5559,1057,1345,1102,243,899,203,State,2022-07-14
2022-02-03,West Central,144,82,62,70,12,13,8,5,5,3,Greater MN,2022-07-14
2021-02-04,Central,832,578,254,560,18,100,61,39,54,7,Greater MN,2022-07-14
2021-02-04,Metro,3814,3431,383,3242,189,817,647,170,595,52,Metro,2022-07-14
2021-02-04,Northeast,949,544,405,528,16,113,84,29,77,7,Greater MN,2022-07-14
2021-02-04,Northwest,329,158,171,149,9,29,12,17,10,2,Greater MN,2022-07-14
2021-02-04,South Central,378,210,168,198,12,25,11,14,10,1,Greater MN,2022-07-14
2021-02-04,Southeast,1281,961,320,932,29,255,153,102,141,12,Greater MN,2022-07-14
2021-02-04,Southwest,375,137,238,133,4,15,4,11,4,0,Greater MN,2022-07-14
2021-02-04,State,8166,6088,2078,5808,280,1374,980,394,898,82,State,2022-07-14
2021-02-04,West Central,208,69,139,66,3,20,8,12,7,1,Greater MN,2022-07-14
2022-02-04,Central,698,634,64,512,122,101,85,16,67,18,Greater MN,2022-07-14
2022-02-04,Metro,4004,3794,210,3155,639,821,702,119,583,119,Metro,2022-07-14
2022-02-04,Northeast,762,541,221,471,70,100,83,17,58,25,Greater MN,2022-07-14
2022-02-04,Northwest,257,171,86,143,28,25,14,11,5,9,Greater MN,2022-07-14
2022-02-04,South Central,314,235,79,197,38,22,9,13,7,2,Greater MN,2022-07-14
2022-02-04,Southeast,1300,1052,248,950,102,251,200,51,172,28,Greater MN,2022-07-14
2022-02-04,Southwest,322,142,180,121,21,14,7,7,4,3,Greater MN,2022-07-14
2022-02-04,State,7801,6649,1152,5616,1033,1346,1106,240,899,207,State,2022-07-14
2022-02-04,West Central,144,80,64,67,13,12,6,6,3,3,Greater MN,2022-07-14
2021-02-05,Central,840,613,227,587,26,98,61,37,56,5,Greater MN,2022-07-14
2021-02-05,Metro,3798,3431,367,3246,185,812,620,192,571,49,Metro,2022-07-14
2021-02-05,Northeast,951,551,400,532,19,113,85,28,77,8,Greater MN,2022-07-14
2021-02-05,Northwest,330,153,177,146,7,29,9,20,5,4,Greater MN,2022-07-14
2021-02-05,South Central,371,220,151,208,12,26,12,14,11,1,Greater MN,2022-07-14
2021-02-05,Southeast,1286,972,314,941,31,257,145,112,133,12,Greater MN,2022-07-14
2021-02-05,Southwest,379,142,237,137,5,12,1,11,1,0,Greater MN,2022-07-14
2021-02-05,State,8163,6153,2010,5865,288,1367,939,428,859,80,State,2022-07-14
2021-02-05,West Central,208,71,137,68,3,20,6,14,5,1,Greater MN,2022-07-14
2022-02-05,Central,683,602,81,489,113,98,81,17,60,21,Greater MN,2022-07-14
2022-02-05,Metro,3930,3651,279,3079,572,795,695,100,587,108,Metro,2022-07-14
2022-02-05,Northeast,755,537,218,459,78,100,65,35,40,25,Greater MN,2022-07-14
2022-02-05,Northwest,258,169,89,139,30,24,13,11,5,8,Greater MN,2022-07-14
2022-02-05,South Central,311,214,97,174,40,22,11,11,9,2,Greater MN,2022-07-14
2022-02-05,Southeast,1294,1041,253,960,81,247,185,62,163,22,Greater MN,2022-07-14
2022-02-05,Southwest,325,131,194,108,23,13,5,8,2,3,Greater MN,2022-07-14
2022-02-05,State,7700,6426,1274,5479,947,1310,1059,251,868,191,State,2022-07-14
2022-02-05,West Central,144,81,63,71,10,11,4,7,2,2,Greater MN,2022-07-14
2021-02-06,Central,818,586,232,562,24,101,63,38,57,6,Greater MN,2022-07-14
2021-02-06,Metro,3700,3308,392,3133,175,812,635,177,585,50,Metro,2022-07-14
2021-02-06,Northeast,934,494,440,474,20,113,73,40,67,6,Greater MN,2022-07-14
2021-02-06,Northwest,328,150,178,144,6,29,15,14,9,6,Greater MN,2022-07-14
2021-02-06,South Central,376,199,177,189,10,24,9,15,9,0,Greater MN,2022-07-14
2021-02-06,Southeast,1283,918,365,884,34,257,159,98,149,10,Greater MN,2022-07-14
2021-02-06,Southwest,363,129,234,126,3,13,1,12,1,0,Greater MN,2022-07-14
2021-02-06,State,8010,5848,2162,5574,274,1369,961,408,882,79,State,2022-07-14
2021-02-06,West Central,208,64,144,62,2,20,6,14,5,1,Greater MN,2022-07-14
2022-02-06,Central,675,614,61,496,118,97,78,19,59,19,Greater MN,2022-07-14
2022-02-06,Metro,3830,3531,299,2982,549,794,688,106,572,116,Metro,2022-07-14
2022-02-06,Northeast,756,513,243,432,81,103,81,22,58,23,Greater MN,2022-07-14
2022-02-06,Northwest,255,160,95,127,33,24,13,11,6,7,Greater MN,2022-07-14
2022-02-06,South Central,315,222,93,180,42,22,11,11,7,4,Greater MN,2022-07-14
2022-02-06,Southeast,1308,997,311,905,92,249,171,78,157,14,Greater MN,2022-07-14
2022-02-06,Southwest,320,118,202,98,20,14,7,7,3,4,Greater MN,2022-07-14
2022-02-06,State,7596,6220,1376,5276,944,1318,1058,260,868,190,State,2022-07-14
2022-02-06,West Central,137,65,72,56,9,15,9,6,6,3,Greater MN,2022-07-14
2021-02-07,Central,796,555,241,532,23,103,65,38,59,6,Greater MN,2022-07-14
2021-02-07,Metro,3657,3157,500,2997,160,795,605,190,548,57,Metro,2022-07-14
2021-02-07,Northeast,946,485,461,469,16,114,68,46,64,4,Greater MN,2022-07-14
2021-02-07,Northwest,329,137,192,132,5,29,13,16,9,4,Greater MN,2022-07-14
2021-02-07,South Central,377,187,190,176,11,24,8,16,8,0,Greater MN,2022-07-14
2021-02-07,Southeast,1284,841,443,811,30,257,138,119,129,9,Greater MN,2022-07-14
2021-02-07,Southwest,368,117,251,113,4,14,1,13,1,0,Greater MN,2022-07-14
2021-02-07,State,7965,5541,2424,5290,251,1356,904,452,824,80,State,2022-07-14
2021-02-07,West Central,208,62,146,60,2,20,6,14,6,0,Greater MN,2022-07-14
2022-02-07,Central,685,637,48,508,129,98,80,18,61,19,Greater MN,2022-07-14
2022-02-07,Metro,3800,3557,243,3001,556,780,685,95,574,111,Metro,2022-07-14
2022-02-07,Northeast,766,523,243,440,83,100,81,19,57,24,Greater MN,2022-07-14
2022-02-07,Northwest,256,157,99,122,35,25,8,17,2,6,Greater MN,2022-07-14
2022-02-07,South Central,312,216,96,173,43,22,10,12,7,3,Greater MN,2022-07-14
2022-02-07,Southeast,1301,996,305,896,100,247,164,83,146,18,Greater MN,2022-07-14
2022-02-07,Southwest,320,126,194,103,23,12,4,8,1,3,Greater MN,2022-07-14
2022-02-07,State,7581,6284,1297,5306,978,1297,1038,259,852,186,State,2022-07-14
2022-02-07,West Central,141,72,69,63,9,13,6,7,4,2,Greater MN,2022-07-14
2021-02-08,Central,811,567,244,539,28,100,62,38,55,7,Greater MN,2022-07-14
2021-02-08,Metro,3607,3090,517,2936,154,772,581,191,532,49,Metro,2022-07-14
2021-02-08,Northeast,940,484,456,468,16,114,69,45,65,4,Greater MN,2022-07-14
2021-02-08,Northwest,328,140,188,136,4,29,12,17,9,3,Greater MN,2022-07-14
2021-02-08,South Central,377,193,184,182,11,24,10,14,10,0,Greater MN,2022-07-14
2021-02-08,Southeast,1281,796,485,765,31,252,125,127,114,11,Greater MN,2022-07-14
2021-02-08,Southwest,352,118,234,117,1,15,2,13,2,0,Greater MN,2022-07-14
2021-02-08,State,7904,5455,2449,5208,247,1326,868,458,794,74,State,2022-07-14
2021-02-08,West Central,208,67,141,65,2,20,7,13,7,0,Greater MN,2022-07-14
2022-02-08,Central,701,647,54,517,130,107,86,21,70,16,Greater MN,2022-07-14
2022-02-08,Metro,3944,3788,156,3233,555,783,694,89,574,120,Metro,2022-07-14
2022-02-08,Northeast,764,527,237,447,80,100,79,21,57,22,Greater MN,2022-07-14
2022-02-08,Northwest,256,149,107,121,28,24,15,9,9,6,Greater MN,2022-07-14
2022-02-08,South Central,316,231,85,180,51,22,10,12,7,3,Greater MN,2022-07-14
2022-02-08,Southeast,1297,1038,259,934,104,247,170,77,154,16,Greater MN,2022-07-14
2022-02-08,Southwest,317,120,197,101,19,14,6,8,3,3,Greater MN,2022-07-14
2022-02-08,State,7739,6577,1162,5606,971,1310,1066,244,877,189,State,2022-07-14
2022-02-08,West Central,144,77,67,73,4,13,6,7,3,3,Greater MN,2022-07-14
2021-02-09,Central,837,593,244,571,22,98,68,30,61,7,Greater MN,2022-07-14
2021-02-09,Metro,3709,3314,395,3153,161,793,626,167,574,52,Metro,2022-07-14
2021-02-09,Northeast,945,512,433,501,11,114,75,39,68,7,Greater MN,2022-07-14
2021-02-09,Northwest,329,149,180,147,2,29,9,20,6,3,Greater MN,2022-07-14
2021-02-09,South Central,377,203,174,194,9,24,9,15,9,0,Greater MN,2022-07-14
2021-02-09,Southeast,1275,849,426,821,28,254,132,122,124,8,Greater MN,2022-07-14
2021-02-09,Southwest,369,140,229,138,2,16,5,11,4,1,Greater MN,2022-07-14
2021-02-09,State,8049,5842,2207,5603,239,1348,933,415,855,78,State,2022-07-14
2021-02-09,West Central,208,82,126,78,4,20,9,11,9,0,Greater MN,2022-07-14
2022-02-09,Central,733,674,59,555,119,102,84,18,71,13,Greater MN,2022-07-14
2022-02-09,Metro,4201,4049,152,3525,524,793,703,90,597,106,Metro,2022-07-14
2022-02-09,Northeast,777,566,211,479,87,102,74,28,54,20,Greater MN,2022-07-14
2022-02-09,Northwest,276,169,107,140,29,22,16,6,9,7,Greater MN,2022-07-14
2022-02-09,South Central,305,236,69,188,48,22,10,12,7,3,Greater MN,2022-07-14
2022-02-09,Southeast,1255,1065,190,971,94,247,176,71,162,14,Greater MN,2022-07-14
2022-02-09,Southwest,321,138,183,122,16,14,6,8,3,3,Greater MN,2022-07-14
2022-02-09,State,8051,7022,1029,6099,923,1314,1073,241,904,169,State,2022-07-14
2022-02-09,West Central,183,125,58,119,6,12,4,8,1,3,Greater MN,2022-07-14
2021-02-10,Central,854,614,240,589,25,94,58,36,51,7,Greater MN,2022-07-14
2021-02-10,Metro,3992,3555,437,3394,161,798,619,179,567,52,Metro,2022-07-14
2021-02-10,Northeast,942,520,422,508,12,114,82,32,76,6,Greater MN,2022-07-14
2021-02-10,Northwest,345,169,176,162,7,29,10,19,7,3,Greater MN,2022-07-14
2021-02-10,South Central,376,212,164,202,10,24,11,13,11,0,Greater MN,2022-07-14
2021-02-10,Southeast,1286,866,420,845,21,254,145,109,138,7,Greater MN,2022-07-14
2021-02-10,Southwest,383,142,241,138,4,15,4,11,3,1,Greater MN,2022-07-14
2021-02-10,State,8418,6213,2205,5969,244,1348,932,416,856,76,State,2022-07-14
2021-02-10,West Central,240,135,105,131,4,20,3,17,3,0,Greater MN,2022-07-14
2022-02-10,Central,702,650,52,546,104,101,81,20,66,15,Greater MN,2022-07-14
2022-02-10,Metro,4075,3885,190,3370,515,793,701,92,606,95,Metro,2022-07-14
2022-02-10,Northeast,769,557,212,475,82,103,84,19,61,23,Greater MN,2022-07-14
2022-02-10,Northwest,261,166,95,143,23,24,15,9,8,7,Greater MN,2022-07-14
2022-02-10,South Central,319,237,82,185,52,22,10,12,8,2,Greater MN,2022-07-14
2022-02-10,Southeast,1297,1096,201,1002,94,253,183,70,169,14,Greater MN,2022-07-14
2022-02-10,Southwest,308,139,169,119,20,14,6,8,4,2,Greater MN,2022-07-14
2022-02-10,State,7874,6828,1046,5935,893,1321,1085,236,925,160,State,2022-07-14
2022-02-10,West Central,143,98,45,95,3,11,5,6,3,2,Greater MN,2022-07-14
2021-02-11,Central,846,606,240,583,23,93,56,37,50,6,Greater MN,2022-07-14
2021-02-11,Metro,3834,3412,422,3246,166,781,626,155,578,48,Metro,2022-07-14
2021-02-11,Northeast,938,551,387,539,12,114,80,34,76,4,Greater MN,2022-07-14
2021-02-11,Northwest,329,179,150,171,8,29,13,16,8,5,Greater MN,2022-07-14
2021-02-11,South Central,378,198,180,184,14,24,11,13,11,0,Greater MN,2022-07-14
2021-02-11,Southeast,1276,893,383,872,21,254,149,105,141,8,Greater MN,2022-07-14
2021-02-11,Southwest,376,148,228,141,7,15,3,12,3,0,Greater MN,2022-07-14
2021-02-11,State,8185,6094,2091,5840,254,1330,943,387,872,71,State,2022-07-14
2021-02-11,West Central,208,107,101,104,3,20,5,15,5,0,Greater MN,2022-07-14
2022-02-11,Central,712,650,62,548,102,104,82,22,67,15,Greater MN,2022-07-14
2022-02-11,Metro,4036,3864,172,3380,484,805,702,103,607,95,Metro,2022-07-14
2022-02-11,Northeast,772,534,238,454,80,108,91,17,67,24,Greater MN,2022-07-14
2022-02-11,Northwest,257,163,94,138,25,24,14,10,6,8,Greater MN,2022-07-14
2022-02-11,South Central,324,230,94,182,48,22,11,11,7,4,Greater MN,2022-07-14
2022-02-11,Southeast,1283,1072,211,980,92,249,180,69,170,10,Greater MN,2022-07-14
2022-02-11,Southwest,305,152,153,134,18,14,8,6,5,3,Greater MN,2022-07-14
2022-02-11,State,7826,6761,1065,5908,853,1339,1095,244,935,160,State,2022-07-14
2022-02-11,West Central,137,96,41,92,4,13,7,6,6,1,Greater MN,2022-07-14
2021-02-12,Central,839,624,215,605,19,93,56,37,51,5,Greater MN,2022-07-14
2021-02-12,Metro,3751,3350,401,3175,175,776,633,143,583,50,Metro,2022-07-14
2021-02-12,Northeast,940,543,397,528,15,114,70,44,67,3,Greater MN,2022-07-14
2021-02-12,Northwest,329,187,142,180,7,29,12,17,7,5,Greater MN,2022-07-14
2021-02-12,South Central,377,212,165,198,14,24,5,19,5,0,Greater MN,2022-07-14
2021-02-12,Southeast,1269,919,350,897,22,254,175,79,168,7,Greater MN,2022-07-14
2021-02-12,Southwest,379,134,245,126,8,15,2,13,2,0,Greater MN,2022-07-14
2021-02-12,State,8092,6064,2028,5803,261,1325,957,368,887,70,State,2022-07-14
2021-02-12,West Central,208,95,113,94,1,20,4,16,4,0,Greater MN,2022-07-14
2022-02-12,Central,683,623,60,522,101,109,87,22,72,15,Greater MN,2022-07-14
2022-02-12,Metro,3939,3760,179,3312,448,797,703,94,606,97,Metro,2022-07-14
2022-02-12,Northeast,766,539,227,462,77,108,60,48,40,20,Greater MN,2022-07-14
2022-02-12,Northwest,258,161,97,137,24,25,12,13,5,7,Greater MN,2022-07-14
2022-02-12,South Central,319,213,106,172,41,24,13,11,9,4,Greater MN,2022-07-14
2022-02-12,Southeast,1279,1056,223,977,79,250,189,61,177,12,Greater MN,2022-07-14
2022-02-12,Southwest,311,136,175,122,14,15,8,7,3,5,Greater MN,2022-07-14
2022-02-12,State,7683,6570,1113,5780,790,1340,1076,264,916,160,State,2022-07-14
2022-02-12,West Central,128,82,46,76,6,12,4,8,4,0,Greater MN,2022-07-14
2021-02-13,Central,843,595,248,573,22,97,60,37,57,3,Greater MN,2022-07-14
2021-02-13,Metro,3616,3225,391,3057,168,795,647,148,597,50,Metro,2022-07-14
2021-02-13,Northeast,936,504,432,491,13,111,75,36,72,3,Greater MN,2022-07-14
2021-02-13,Northwest,328,168,160,160,8,29,10,19,5,5,Greater MN,2022-07-14
2021-02-13,South Central,375,196,179,182,14,24,10,14,10,0,Greater MN,2022-07-14
2021-02-13,Southeast,1278,952,326,924,28,254,163,91,160,3,Greater MN,2022-07-14
2021-02-13,Southwest,375,139,236,133,6,15,2,13,2,0,Greater MN,2022-07-14
2021-02-13,State,7959,5851,2108,5592,259,1345,972,373,908,64,State,2022-07-14
2021-02-13,West Central,208,72,136,72,0,20,5,15,5,0,Greater MN,2022-07-14
2022-02-13,Central,657,584,73,483,101,96,76,20,63,13,Greater MN,2022-07-14
2022-02-13,Metro,3849,3631,218,3192,439,772,674,98,577,97,Metro,2022-07-14
2022-02-13,Northeast,767,515,252,438,77,106,70,36,53,17,Greater MN,2022-07-14
2022-02-13,Northwest,260,156,104,138,18,25,16,9,7,9,Greater MN,2022-07-14
2022-02-13,South Central,319,213,106,173,40,22,10,12,7,3,Greater MN,2022-07-14
2022-02-13,Southeast,1295,976,319,893,83,252,173,79,163,10,Greater MN,2022-07-14
2022-02-13,Southwest,311,127,184,114,13,14,5,9,2,3,Greater MN,2022-07-14
2022-02-13,State,7589,6270,1319,5496,774,1300,1028,272,876,152,State,2022-07-14
2022-02-13,West Central,131,68,63,65,3,13,4,9,4,0,Greater MN,2022-07-14
2021-02-14,Central,812,549,263,527,22,98,60,38,57,3,Greater MN,2022-07-14
2021-02-14,Metro,3545,3035,510,2869,166,799,639,160,586,53,Metro,2022-07-14
2021-02-14,Northeast,937,488,449,475,13,110,65,45,63,2,Greater MN,2022-07-14
2021-02-14,Northwest,328,150,178,143,7,29,13,16,8,5,Greater MN,2022-07-14
2021-02-14,South Central,373,187,186,172,15,24,10,14,10,0,Greater MN,2022-07-14
2021-02-14,Southeast,1281,856,425,828,28,255,142,113,139,3,Greater MN,2022-07-14
2021-02-14,Southwest,379,134,245,129,5,15,1,14,1,0,Greater MN,2022-07-14
2021-02-14,State,7863,5465,2398,5209,256,1350,934,416,868,66,State,2022-07-14
2021-02-14,West Central,208,66,142,66,0,20,4,16,4,0,Greater MN,2022-07-14
2022-02-14,Central,661,577,84,482,95,101,82,19,66,16,Greater MN,2022-07-14
2022-02-14,Metro,3769,3538,231,3111,427,766,640,126,546,94,Metro,2022-07-14
2022-02-14,Northeast,767,513,254,429,84,107,73,34,55,18,Greater MN,2022-07-14
2022-02-14,Northwest,252,163,89,146,17,22,14,8,6,8,Greater MN,2022-07-14
2022-02-14,South Central,322,197,125,166,31,22,11,11,8,3,Greater MN,2022-07-14
2022-02-14,Southeast,1277,941,336,868,73,252,174,78,164,10,Greater MN,2022-07-14
2022-02-14,Southwest,313,135,178,122,13,14,8,6,4,4,Greater MN,2022-07-14
2022-02-14,State,7493,6138,1355,5393,745,1295,1004,291,851,153,State,2022-07-14
2022-02-14,West Central,132,74,58,69,5,11,2,9,2,0,Greater MN,2022-07-14
2021-02-15,Central,800,549,251,528,21,98,63,35,60,3,Greater MN,2022-07-14
2021-02-15,Metro,3514,3006,508,2840,166,783,634,149,588,46,Metro,2022-07-14
2021-02-15,Northeast,934,507,427,494,13,113,68,45,66,2,Greater MN,2022-07-14
2021-02-15,Northwest,329,159,170,151,8,29,8,21,5,3,Greater MN,2022-07-14
2021-02-15,South Central,373,213,160,197,16,24,6,18,6,0,Greater MN,2022-07-14
2021-02-15,Southeast,1271,825,446,796,29,256,138,118,135,3,Greater MN,2022-07-14
2021-02-15,Southwest,377,130,247,125,5,15,0,15,0,0,Greater MN,2022-07-14
2021-02-15,State,7806,5444,2362,5186,258,1338,923,415,866,57,State,2022-07-14
2021-02-15,West Central,208,55,153,55,0,20,6,14,6,0,Greater MN,2022-07-14
2022-02-15,Central,698,638,60,542,96,99,74,25,61,13,Greater MN,2022-07-14
2022-02-15,Metro,3914,3685,229,3269,416,763,665,98,585,80,Metro,2022-07-14
2022-02-15,Northeast,769,533,236,477,56,102,74,28,58,16,Greater MN,2022-07-14
2022-02-15,Northwest,256,161,95,145,16,22,13,9,6,7,Greater MN,2022-07-14
2022-02-15,South Central,325,229,96,203,26,22,9,13,6,3,Greater MN,2022-07-14
2022-02-15,Southeast,1287,1017,270,952,65,261,189,72,174,15,Greater MN,2022-07-14
2022-02-15,Southwest,310,122,188,110,12,13,8,5,4,4,Greater MN,2022-07-14
2022-02-15,State,7696,6465,1231,5773,692,1296,1039,257,899,140,State,2022-07-14
2022-02-15,West Central,137,80,57,75,5,14,7,7,5,2,Greater MN,2022-07-14
2021-02-16,Central,840,572,268,548,24,93,53,40,50,3,Greater MN,2022-07-14
2021-02-16,Metro,3678,3220,458,3043,177,789,641,148,596,45,Metro,2022-07-14
2021-02-16,Northeast,936,521,415,516,5,113,70,43,69,1,Greater MN,2022-07-14
2021-02-16,Northwest,329,167,162,160,7,29,10,19,7,3,Greater MN,2022-07-14
2021-02-16,South Central,376,232,144,216,16,24,5,19,5,0,Greater MN,2022-07-14
2021-02-16,Southeast,1277,859,418,834,25,256,160,96,158,2,Greater MN,2022-07-14
2021-02-16,Southwest,381,142,239,137,5,15,1,14,1,0,Greater MN,2022-07-14
2021-02-16,State,8025,5779,2246,5519,260,1339,944,395,890,54,State,2022-07-14
2021-02-16,West Central,208,66,142,65,1,20,4,16,4,0,Greater MN,2022-07-14
2022-02-16,Central,761,704,57,621,83,105,78,27,67,11,Greater MN,2022-07-14
2022-02-16,Metro,4145,3912,233,3501,411,776,661,115,581,80,Metro,2022-07-14
2022-02-16,Northeast,769,562,207,500,62,102,84,18,68,16,Greater MN,2022-07-14
2022-02-16,Northwest,272,170,102,155,15,22,16,6,10,6,Greater MN,2022-07-14
2022-02-16,South Central,323,226,97,193,33,22,10,12,8,2,Greater MN,2022-07-14
2022-02-16,Southeast,1318,1084,234,1026,58,262,195,67,182,13,Greater MN,2022-07-14
2022-02-16,Southwest,322,130,192,117,13,14,8,6,4,4,Greater MN,2022-07-14
2022-02-16,State,8079,6902,1177,6222,680,1315,1057,258,923,134,State,2022-07-14
2022-02-16,West Central,169,114,55,109,5,12,5,7,3,2,Greater MN,2022-07-14
2021-02-17,Central,859,601,258,580,21,102,71,31,66,5,Greater MN,2022-07-14
2021-02-17,Metro,3946,3533,413,3368,165,796,663,133,616,47,Metro,2022-07-14
2021-02-17,Northeast,944,529,415,523,6,113,70,43,70,0,Greater MN,2022-07-14
2021-02-17,Northwest,344,170,174,164,6,29,7,22,5,2,Greater MN,2022-07-14
2021-02-17,South Central,380,234,146,218,16,24,6,18,6,0,Greater MN,2022-07-14
2021-02-17,Southeast,1283,899,384,872,27,257,156,101,152,4,Greater MN,2022-07-14
2021-02-17,Southwest,405,157,248,154,3,15,1,14,1,0,Greater MN,2022-07-14
2021-02-17,State,8401,6231,2170,5986,245,1356,978,378,920,58,State,2022-07-14
2021-02-17,West Central,240,108,132,107,1,20,4,16,4,0,Greater MN,2022-07-14
2022-02-17,Central,748,709,39,626,83,100,74,26,63,11,Greater MN,2022-07-14
2022-02-17,Metro,4027,3840,187,3443,397,780,664,116,582,82,Metro,2022-07-14
2022-02-17,Northeast,760,543,217,479,64,102,73,29,59,14,Greater MN,2022-07-14
2022-02-17,Northwest,261,163,98,150,13,22,16,6,8,8,Greater MN,2022-07-14
2022-02-17,South Central,324,232,92,202,30,22,10,12,7,3,Greater MN,2022-07-14
2022-02-17,Southeast,1291,1053,238,993,60,260,182,78,169,13,Greater MN,2022-07-14
2022-02-17,Southwest,309,113,196,100,13,13,7,6,4,3,Greater MN,2022-07-14
2022-02-17,State,7857,6743,1114,6075,668,1311,1030,281,896,134,State,2022-07-14
2022-02-17,West Central,137,90,47,82,8,12,4,8,4,0,Greater MN,2022-07-14
2021-02-18,Central,829,582,247,561,21,97,63,34,59,4,Greater MN,2022-07-14
2021-02-18,Metro,3825,3349,476,3202,147,817,675,142,629,46,Metro,2022-07-14
2021-02-18,Northeast,945,500,445,492,8,113,75,38,73,2,Greater MN,2022-07-14
2021-02-18,Northwest,329,169,160,163,6,29,9,20,8,1,Greater MN,2022-07-14
2021-02-18,South Central,384,241,143,226,15,24,6,18,6,0,Greater MN,2022-07-14
2021-02-18,Southeast,1271,927,344,906,21,255,153,102,147,6,Greater MN,2022-07-14
2021-02-18,Southwest,386,147,239,145,2,15,3,12,3,0,Greater MN,2022-07-14
2021-02-18,State,8177,5996,2181,5774,222,1370,989,381,930,59,State,2022-07-14
2021-02-18,West Central,208,81,127,79,2,20,5,15,5,0,Greater MN,2022-07-14
2022-02-18,Central,704,653,51,586,67,97,73,24,60,13,Greater MN,2022-07-14
2022-02-18,Metro,4051,3849,202,3470,379,769,659,110,586,73,Metro,2022-07-14
2022-02-18,Northeast,754,525,229,467,58,103,79,24,67,12,Greater MN,2022-07-14
2022-02-18,Northwest,261,154,107,142,12,22,17,5,9,8,Greater MN,2022-07-14
2022-02-18,South Central,321,223,98,202,21,22,10,12,7,3,Greater MN,2022-07-14
2022-02-18,Southeast,1287,1046,241,982,64,259,177,82,164,13,Greater MN,2022-07-14
2022-02-18,Southwest,300,114,186,100,14,11,5,6,3,2,Greater MN,2022-07-14
2022-02-18,State,7812,6634,1178,6011,623,1296,1026,270,902,124,State,2022-07-14
2022-02-18,West Central,134,70,64,62,8,13,6,7,6,0,Greater MN,2022-07-14
2021-02-19,Central,838,602,236,579,23,99,65,34,61,4,Greater MN,2022-07-14
2021-02-19,Metro,3837,3426,411,3284,142,811,677,134,639,38,Metro,2022-07-14
2021-02-19,Northeast,948,521,427,513,8,113,78,35,77,1,Greater MN,2022-07-14
2021-02-19,Northwest,330,162,168,154,8,29,12,17,10,2,Greater MN,2022-07-14
2021-02-19,South Central,380,243,137,227,16,24,7,17,6,1,Greater MN,2022-07-14
2021-02-19,Southeast,1267,935,332,906,29,255,157,98,152,5,Greater MN,2022-07-14
2021-02-19,Southwest,370,139,231,136,3,14,4,10,4,0,Greater MN,2022-07-14
2021-02-19,State,8178,6104,2074,5872,232,1365,1005,360,954,51,State,2022-07-14
2021-02-19,West Central,208,76,132,73,3,20,5,15,5,0,Greater MN,2022-07-14
2022-02-19,Central,703,625,78,558,67,102,76,26,64,12,Greater MN,2022-07-14
2022-02-19,Metro,3985,3679,306,3330,349,780,656,124,588,68,Metro,2022-07-14
2022-02-19,Northeast,755,493,262,440,53,100,72,28,61,11,Greater MN,2022-07-14
2022-02-19,Northwest,256,129,127,117,12,24,17,7,9,8,Greater MN,2022-07-14
2022-02-19,South Central,319,198,121,179,19,22,7,15,5,2,Greater MN,2022-07-14
2022-02-19,Southeast,1289,1025,264,969,56,256,188,68,174,14,Greater MN,2022-07-14
2022-02-19,Southwest,298,102,196,94,8,14,3,11,1,2,Greater MN,2022-07-14
2022-02-19,State,7739,6320,1419,5754,566,1311,1025,286,908,117,State,2022-07-14
2022-02-19,West Central,134,69,65,67,2,13,6,7,6,0,Greater MN,2022-07-14
2021-02-20,Central,838,594,244,572,22,102,74,28,70,4,Greater MN,2022-07-14
2021-02-20,Metro,3747,3289,458,3164,125,815,675,140,637,38,Metro,2022-07-14
2021-02-20,Northeast,946,509,437,502,7,113,72,41,71,1,Greater MN,2022-07-14
2021-02-20,Northwest,329,140,189,135,5,29,12,17,11,1,Greater MN,2022-07-14
2021-02-20,South Central,368,208,160,195,13,25,10,15,8,2,Greater MN,2022-07-14
2021-02-20,Southeast,1283,945,338,918,27,257,158,99,154,4,Greater MN,2022-07-14
2021-02-20,Southwest,364,124,240,122,2,14,3,11,3,0,Greater MN,2022-07-14
2021-02-20,State,8083,5881,2202,5678,203,1375,1008,367,958,50,State,2022-07-14
2021-02-20,West Central,208,72,136,70,2,20,4,16,4,0,Greater MN,2022-07-14
2022-02-20,Central,666,582,84,508,74,108,86,22,73,13,Greater MN,2022-07-14
2022-02-20,Metro,3792,3569,223,3237,332,764,643,121,579,64,Metro,2022-07-14
2022-02-20,Northeast,759,491,268,443,48,104,77,27,62,15,Greater MN,2022-07-14
2022-02-20,Northwest,255,116,139,106,10,25,15,10,6,9,Greater MN,2022-07-14
2022-02-20,South Central,318,196,122,177,19,22,8,14,6,2,Greater MN,2022-07-14
2022-02-20,Southeast,1299,948,351,893,55,257,164,93,152,12,Greater MN,2022-07-14
2022-02-20,Southwest,304,102,202,93,9,13,2,11,0,2,Greater MN,2022-07-14
2022-02-20,State,7528,6075,1453,5525,550,1305,999,306,882,117,State,2022-07-14
2022-02-20,West Central,135,71,64,68,3,12,4,8,4,0,Greater MN,2022-07-14
2021-02-21,Central,800,529,271,505,24,101,68,33,65,3,Greater MN,2022-07-14
2021-02-21,Metro,3570,3059,511,2938,121,815,655,160,616,39,Metro,2022-07-14
2021-02-21,Northeast,942,519,423,513,6,114,75,39,74,1,Greater MN,2022-07-14
2021-02-21,Northwest,328,139,189,134,5,29,12,17,11,1,Greater MN,2022-07-14
2021-02-21,South Central,367,212,155,199,13,24,9,15,7,2,Greater MN,2022-07-14
2021-02-21,Southeast,1278,832,446,809,23,256,137,119,135,2,Greater MN,2022-07-14
2021-02-21,Southwest,368,129,239,126,3,13,1,12,1,0,Greater MN,2022-07-14
2021-02-21,State,7861,5476,2385,5281,195,1372,961,411,913,48,State,2022-07-14
2021-02-21,West Central,208,57,151,57,0,20,4,16,4,0,Greater MN,2022-07-14
2022-02-21,Central,688,592,96,524,68,101,78,23,67,11,Greater MN,2022-07-14
2022-02-21,Metro,3773,3548,225,3235,313,763,645,118,587,58,Metro,2022-07-14
2022-02-21,Northeast,764,479,285,432,47,102,76,26,61,15,Greater MN,2022-07-14
2022-02-21,Northwest,260,118,142,108,10,24,16,8,6,10,Greater MN,2022-07-14
2022-02-21,South Central,322,207,115,188,19,22,10,12,8,2,Greater MN,2022-07-14
2022-02-21,Southeast,1299,937,362,881,56,257,158,99,147,11,Greater MN,2022-07-14
2022-02-21,Southwest,304,108,196,100,8,13,1,12,0,1,Greater MN,2022-07-14
2022-02-21,State,7542,6059,1483,5533,526,1294,986,308,878,108,State,2022-07-14
2022-02-21,West Central,132,70,62,65,5,12,2,10,2,0,Greater MN,2022-07-14
2021-02-22,Central,812,515,297,492,23,98,64,34,61,3,Greater MN,2022-07-14
2021-02-22,Metro,3557,3092,465,2954,138,803,654,149,609,45,Metro,2022-07-14
2021-02-22,Northeast,946,542,404,535,7,114,79,35,77,2,Greater MN,2022-07-14
2021-02-22,Northwest,329,153,176,148,5,29,10,19,9,1,Greater MN,2022-07-14
2021-02-22,South Central,373,205,168,188,17,24,10,14,8,2,Greater MN,2022-07-14
2021-02-22,Southeast,1275,820,455,798,22,253,127,126,125,2,Greater MN,2022-07-14
2021-02-22,Southwest,363,115,248,113,2,14,2,12,2,0,Greater MN,2022-07-14
2021-02-22,State,7863,5504,2359,5290,214,1355,952,403,897,55,State,2022-07-14
2021-02-22,West Central,208,62,146,62,0,20,6,14,6,0,Greater MN,2022-07-14
2022-02-22,Central,705,638,67,571,67,101,86,15,76,10,Greater MN,2022-07-14
2022-02-22,Metro,3918,3731,187,3427,304,781,666,115,605,61,Metro,2022-07-14
2022-02-22,Northeast,753,515,238,470,45,100,78,22,63,15,Greater MN,2022-07-14
2022-02-22,Northwest,257,144,113,130,14,24,14,10,8,6,Greater MN,2022-07-14
2022-02-22,South Central,319,198,121,180,18,22,8,14,7,1,Greater MN,2022-07-14
2022-02-22,Southeast,1294,1002,292,942,60,255,169,86,160,9,Greater MN,2022-07-14
2022-02-22,Southwest,309,121,188,113,8,11,5,6,4,1,Greater MN,2022-07-14
2022-02-22,State,7706,6441,1265,5920,521,1303,1027,276,924,103,State,2022-07-14
2022-02-22,West Central,151,92,59,87,5,9,1,8,1,0,Greater MN,2022-07-14
2021-02-23,Central,845,628,217,603,25,103,70,33,67,3,Greater MN,2022-07-14
2021-02-23,Metro,3780,3407,373,3252,155,826,682,144,638,44,Metro,2022-07-14
2021-02-23,Northeast,950,544,406,535,9,112,78,34,75,3,Greater MN,2022-07-14
2021-02-23,Northwest,329,151,178,143,8,29,12,17,10,2,Greater MN,2022-07-14
2021-02-23,South Central,382,226,156,208,18,24,9,15,7,2,Greater MN,2022-07-14
2021-02-23,Southeast,1273,888,385,871,17,253,134,119,129,5,Greater MN,2022-07-14
2021-02-23,Southwest,374,135,239,135,0,15,3,12,3,0,Greater MN,2022-07-14
2021-02-23,State,8141,6060,2081,5827,233,1382,996,386,937,59,State,2022-07-14
2021-02-23,West Central,208,81,127,80,1,20,8,12,8,0,Greater MN,2022-07-14
2022-02-23,Central,729,672,57,603,69,96,73,23,65,8,Greater MN,2022-07-14
2022-02-23,Metro,4217,4025,192,3725,300,792,669,123,612,57,Metro,2022-07-14
2022-02-23,Northeast,768,547,221,501,46,100,76,24,62,14,Greater MN,2022-07-14
2022-02-23,Northwest,274,162,112,146,16,24,16,8,9,7,Greater MN,2022-07-14
2022-02-23,South Central,319,222,97,207,15,22,9,13,7,2,Greater MN,2022-07-14
2022-02-23,Southeast,1320,1074,246,1015,59,257,175,82,166,9,Greater MN,2022-07-14
2022-02-23,Southwest,323,137,186,127,10,11,6,5,5,1,Greater MN,2022-07-14
2022-02-23,State,8137,6960,1177,6441,519,1311,1027,284,929,98,State,2022-07-14
2022-02-23,West Central,187,121,66,117,4,9,3,6,3,0,Greater MN,2022-07-14
2021-02-24,Central,872,669,203,645,24,97,64,33,63,1,Greater MN,2022-07-14
2021-02-24,Metro,4043,3670,373,3525,145,826,694,132,651,43,Metro,2022-07-14
2021-02-24,Northeast,950,561,389,550,11,114,78,36,75,3,Greater MN,2022-07-14
2021-02-24,Northwest,346,185,161,177,8,29,10,19,8,2,Greater MN,2022-07-14
2021-02-24,South Central,378,235,143,221,14,24,11,13,9,2,Greater MN,2022-07-14
2021-02-24,Southeast,1295,974,321,954,20,257,134,123,132,2,Greater MN,2022-07-14
2021-02-24,Southwest,387,145,242,144,1,15,1,14,1,0,Greater MN,2022-07-14
2021-02-24,State,8511,6549,1962,6325,224,1382,997,385,944,53,State,2022-07-14
2021-02-24,West Central,240,110,130,109,1,20,5,15,5,0,Greater MN,2022-07-14
2022-02-24,Central,683,619,64,550,69,104,81,23,71,10,Greater MN,2022-07-14
2022-02-24,Metro,4038,3884,154,3590,294,769,647,122,594,53,Metro,2022-07-14
2022-02-24,Northeast,763,529,234,491,38,100,74,26,61,13,Greater MN,2022-07-14
2022-02-24,Northwest,264,144,120,126,18,24,13,11,7,6,Greater MN,2022-07-14
2022-02-24,South Central,319,216,103,201,15,22,11,11,7,4,Greater MN,2022-07-14
2022-02-24,Southeast,1304,1037,267,986,51,261,182,79,175,7,Greater MN,2022-07-14
2022-02-24,Southwest,310,127,183,117,10,13,3,10,2,1,Greater MN,2022-07-14
2022-02-24,State,7835,6642,1193,6141,501,1302,1017,285,923,94,State,2022-07-14
2022-02-24,West Central,154,86,68,80,6,9,6,3,6,0,Greater MN,2022-07-14
2021-02-25,Central,827,598,229,581,17,103,68,35,65,3,Greater MN,2022-07-14
2021-02-25,Metro,3901,3589,312,3457,132,830,671,159,624,47,Metro,2022-07-14
2021-02-25,Northeast,949,533,416,524,9,112,74,38,70,4,Greater MN,2022-07-14
2021-02-25,Northwest,330,172,158,161,11,29,10,19,10,0,Greater MN,2022-07-14
2021-02-25,South Central,377,239,138,223,16,26,13,13,10,3,Greater MN,2022-07-14
2021-02-25,Southeast,1273,967,306,951,16,252,155,97,152,3,Greater MN,2022-07-14
2021-02-25,Southwest,378,149,229,147,2,15,2,13,2,0,Greater MN,2022-07-14
2021-02-25,State,8243,6324,1919,6121,203,1387,999,388,939,60,State,2022-07-14
2021-02-25,West Central,208,77,131,77,0,20,6,14,6,0,Greater MN,2022-07-14
2022-02-25,Central,698,623,75,559,64,101,75,26,67,8,Greater MN,2022-07-14
2022-02-25,Metro,3995,3805,190,3526,279,761,658,103,610,48,Metro,2022-07-14
2022-02-25,Northeast,765,521,244,484,37,102,72,30,61,11,Greater MN,2022-07-14
2022-02-25,Northwest,265,132,133,120,12,24,15,9,9,6,Greater MN,2022-07-14
2022-02-25,South Central,316,205,111,190,15,22,11,11,8,3,Greater MN,2022-07-14
2022-02-25,Southeast,1293,1030,263,981,49,257,191,66,183,8,Greater MN,2022-07-14
2022-02-25,Southwest,305,110,195,101,9,14,5,9,4,1,Greater MN,2022-07-14
2022-02-25,State,7791,6519,1272,6048,471,1289,1031,258,945,86,State,2022-07-14
2022-02-25,West Central,154,93,61,87,6,8,4,4,3,1,Greater MN,2022-07-14
2021-02-26,Central,820,583,237,573,10,93,59,34,56,3,Greater MN,2022-07-14
2021-02-26,Metro,3842,3554,288,3420,134,831,685,146,641,44,Metro,2022-07-14
2021-02-26,Northeast,946,506,440,494,12,114,77,37,75,2,Greater MN,2022-07-14
2021-02-26,Northwest,329,188,141,179,9,30,14,16,14,0,Greater MN,2022-07-14
2021-02-26,South Central,377,216,161,204,12,25,8,17,6,2,Greater MN,2022-07-14
2021-02-26,Southeast,1281,980,301,968,12,253,162,91,158,4,Greater MN,2022-07-14
2021-02-26,Southwest,365,110,255,108,2,15,2,13,2,0,Greater MN,2022-07-14
2021-02-26,State,8168,6218,1950,6025,193,1381,1013,368,958,55,State,2022-07-14
2021-02-26,West Central,208,81,127,79,2,20,6,14,6,0,Greater MN,2022-07-14
2022-02-26,Central,684,588,96,531,57,102,75,27,67,8,Greater MN,2022-07-14
2022-02-26,Metro,3953,3755,198,3491,264,772,658,114,617,41,Metro,2022-07-14
2022-02-26,Northeast,766,514,252,478,36,100,73,27,62,11,Greater MN,2022-07-14
2022-02-26,Northwest,260,120,140,108,12,24,11,13,8,3,Greater MN,2022-07-14
2022-02-26,South Central,316,211,105,193,18,22,10,12,8,2,Greater MN,2022-07-14
2022-02-26,Southeast,1310,1048,262,1003,45,255,189,66,180,9,Greater MN,2022-07-14
2022-02-26,Southwest,298,106,192,99,7,15,5,10,4,1,Greater MN,2022-07-14
2022-02-26,State,7738,6424,1314,5984,440,1299,1025,274,950,75,State,2022-07-14
2022-02-26,West Central,151,82,69,81,1,9,4,5,4,0,Greater MN,2022-07-14
2021-02-27,Central,817,577,240,568,9,96,60,36,57,3,Greater MN,2022-07-14
2021-02-27,Metro,3805,3470,335,3346,124,837,670,167,630,40,Metro,2022-07-14
2021-02-27,Northeast,945,472,473,463,9,114,70,44,67,3,Greater MN,2022-07-14
2021-02-27,Northwest,328,144,184,135,9,29,12,17,12,0,Greater MN,2022-07-14
2021-02-27,South Central,375,194,181,180,14,24,8,16,6,2,Greater MN,2022-07-14
2021-02-27,Southeast,1273,948,325,937,11,254,163,91,160,3,Greater MN,2022-07-14
2021-02-27,Southwest,358,112,246,110,2,13,1,12,1,0,Greater MN,2022-07-14
2021-02-27,State,8109,5999,2110,5820,179,1387,991,396,940,51,State,2022-07-14
2021-02-27,West Central,208,82,126,81,1,20,7,13,7,0,Greater MN,2022-07-14
2022-02-27,Central,658,553,105,491,62,102,75,27,64,11,Greater MN,2022-07-14
2022-02-27,Metro,3911,3656,255,3393,263,754,642,112,601,41,Metro,2022-07-14
2022-02-27,Northeast,769,520,249,483,37,101,74,27,62,12,Greater MN,2022-07-14
2022-02-27,Northwest,248,134,114,121,13,25,15,10,12,3,Greater MN,2022-07-14
2022-02-27,South Central,314,193,121,176,17,22,9,13,7,2,Greater MN,2022-07-14
2022-02-27,Southeast,1301,1000,301,955,45,255,178,77,169,9,Greater MN,2022-07-14
2022-02-27,Southwest,297,101,196,94,7,13,3,10,2,1,Greater MN,2022-07-14
2022-02-27,State,7651,6242,1409,5797,445,1280,999,281,920,79,State,2022-07-14
2022-02-27,West Central,153,85,68,84,1,8,3,5,3,0,Greater MN,2022-07-14
2021-02-28,Central,808,561,247,551,10,97,62,35,58,4,Greater MN,2022-07-14
2021-02-28,Metro,3642,3206,436,3078,128,830,672,158,637,35,Metro,2022-07-14
2021-02-28,Northeast,945,480,465,471,9,114,55,59,53,2,Greater MN,2022-07-14
2021-02-28,Northwest,328,155,173,146,9,29,8,21,8,0,Greater MN,2022-07-14
2021-02-28,South Central,370,193,177,176,17,25,11,14,9,2,Greater MN,2022-07-14
2021-02-28,Southeast,1280,838,442,828,10,256,137,119,133,4,Greater MN,2022-07-14
2021-02-28,Southwest,367,109,258,107,2,14,2,12,2,0,Greater MN,2022-07-14
2021-02-28,State,7948,5618,2330,5433,185,1385,954,431,907,47,State,2022-07-14
2021-02-28,West Central,208,76,132,76,0,20,7,13,7,0,Greater MN,2022-07-14
2022-02-28,Central,654,561,93,499,62,100,74,26,65,9,Greater MN,2022-07-14
2022-02-28,Metro,3880,3600,280,3350,250,770,639,131,594,45,Metro,2022-07-14
2022-02-28,Northeast,769,533,236,496,37,102,72,30,60,12,Greater MN,2022-07-14
2022-02-28,Northwest,246,137,109,126,11,25,18,7,14,4,Greater MN,2022-07-14
2022-02-28,South Central,320,224,96,207,17,22,10,12,8,2,Greater MN,2022-07-14
2022-02-28,Southeast,1291,966,325,927,39,256,166,90,158,8,Greater MN,2022-07-14
2022-02-28,Southwest,307,110,197,104,6,13,3,10,2,1,Greater MN,2022-07-14
2022-02-28,State,7614,6215,1399,5786,429,1296,987,309,906,81,State,2022-07-14
2022-02-28,West Central,147,84,63,77,7,8,5,3,5,0,Greater MN,2022-07-14
2021-03-01,Central,791,553,238,537,16,100,66,34,63,3,Greater MN,2022-07-14
2021-03-01,Metro,3685,3256,429,3127,129,839,672,167,625,47,Metro,2022-07-14
2021-03-01,Northeast,933,494,439,486,8,114,67,47,62,5,Greater MN,2022-07-14
2021-03-01,Northwest,328,165,163,156,9,29,10,19,10,0,Greater MN,2022-07-14
2021-03-01,South Central,370,196,174,180,16,24,10,14,8,2,Greater MN,2022-07-14
2021-03-01,Southeast,1273,823,450,811,12,253,129,124,126,3,Greater MN,2022-07-14
2021-03-01,Southwest,371,119,252,118,1,14,1,13,1,0,Greater MN,2022-07-14
2021-03-01,State,7959,5677,2282,5486,191,1393,959,434,899,60,State,2022-07-14
2021-03-01,West Central,208,71,137,71,0,20,4,16,4,0,Greater MN,2022-07-14
2022-03-01,Central,678,614,64,550,64,111,84,27,74,10,Greater MN,2022-07-14
2022-03-01,Metro,3985,3827,158,3567,260,781,667,114,624,43,Metro,2022-07-14
2022-03-01,Northeast,775,536,239,509,27,99,69,30,55,14,Greater MN,2022-07-14
2022-03-01,Northwest,248,147,101,137,10,25,18,7,16,2,Greater MN,2022-07-14
2022-03-01,South Central,316,230,86,217,13,22,9,13,7,2,Greater MN,2022-07-14
2022-03-01,Southeast,1295,1023,272,985,38,261,185,76,179,6,Greater MN,2022-07-14
2022-03-01,Southwest,310,115,195,109,6,13,3,10,2,1,Greater MN,2022-07-14
2022-03-01,State,7768,6599,1169,6174,425,1321,1039,282,961,78,State,2022-07-14
2022-03-01,West Central,161,107,54,100,7,9,4,5,4,0,Greater MN,2022-07-14
2021-03-02,Central,810,582,228,569,13,102,71,31,67,4,Greater MN,2022-07-14
2021-03-02,Metro,3753,3455,298,3333,122,833,684,149,637,47,Metro,2022-07-14
2021-03-02,Northeast,938,520,418,510,10,114,67,47,64,3,Greater MN,2022-07-14
2021-03-02,Northwest,344,154,190,147,7,29,11,18,10,1,Greater MN,2022-07-14
2021-03-02,South Central,370,210,160,196,14,27,13,14,11,2,Greater MN,2022-07-14
2021-03-02,Southeast,1256,881,375,866,15,250,142,108,139,3,Greater MN,2022-07-14
2021-03-02,Southwest,377,112,265,111,1,14,1,13,1,0,Greater MN,2022-07-14
2021-03-02,State,8056,6000,2056,5817,183,1389,995,394,935,60,State,2022-07-14
2021-03-02,West Central,208,86,122,85,1,20,6,14,6,0,Greater MN,2022-07-14
2022-03-02,Central,709,654,55,590,64,111,89,22,76,13,Greater MN,2022-07-14
2022-03-02,Metro,4307,4075,232,3823,252,781,676,105,644,32,Metro,2022-07-14
2022-03-02,Northeast,779,534,245,506,28,100,77,23,64,13,Greater MN,2022-07-14
2022-03-02,Northwest,269,164,105,154,10,25,16,9,13,3,Greater MN,2022-07-14
2022-03-02,South Central,322,240,82,228,12,22,7,15,4,3,Greater MN,2022-07-14
2022-03-02,Southeast,1316,1072,244,1036,36,262,194,68,186,8,Greater MN,2022-07-14
2022-03-02,Southwest,323,137,186,130,7,12,3,9,2,1,Greater MN,2022-07-14
2022-03-02,State,8220,7011,1209,6595,416,1323,1068,255,994,74,State,2022-07-14
2022-03-02,West Central,195,135,60,128,7,10,6,4,5,1,Greater MN,2022-07-14
2021-03-03,Central,858,675,183,664,11,101,63,38,58,5,Greater MN,2022-07-14
2021-03-03,Metro,3972,3681,291,3563,118,849,703,146,658,45,Metro,2022-07-14
2021-03-03,Northeast,938,524,414,518,6,112,76,36,72,4,Greater MN,2022-07-14
2021-03-03,Northwest,344,170,174,163,7,29,13,16,13,0,Greater MN,2022-07-14
2021-03-03,South Central,371,200,171,185,15,26,7,19,5,2,Greater MN,2022-07-14
2021-03-03,Southeast,1282,927,355,915,12,249,156,93,153,3,Greater MN,2022-07-14
2021-03-03,Southwest,392,121,271,120,1,14,3,11,3,0,Greater MN,2022-07-14
2021-03-03,State,8397,6423,1974,6253,170,1400,1025,375,966,59,State,2022-07-14
2021-03-03,West Central,240,125,115,125,0,20,4,16,4,0,Greater MN,2022-07-14
2022-03-03,Central,646,584,62,521,63,107,86,21,76,10,Greater MN,2022-07-14
2022-03-03,Metro,4120,3914,206,3671,243,782,684,98,655,29,Metro,2022-07-14
2022-03-03,Northeast,774,521,253,495,26,102,79,23,69,10,Greater MN,2022-07-14
2022-03-03,Northwest,254,143,111,134,9,24,20,4,17,3,Greater MN,2022-07-14
2022-03-03,South Central,321,245,76,233,12,22,7,15,6,1,Greater MN,2022-07-14
2022-03-03,Southeast,1293,1050,243,1008,42,257,179,78,171,8,Greater MN,2022-07-14
2022-03-03,Southwest,315,120,195,114,6,12,2,10,1,1,Greater MN,2022-07-14
2022-03-03,State,7891,6680,1211,6272,408,1317,1063,254,999,64,State,2022-07-14
2022-03-03,West Central,168,103,65,96,7,11,6,5,4,2,Greater MN,2022-07-14
2021-03-04,Central,826,628,198,615,13,105,65,40,60,5,Greater MN,2022-07-14
2021-03-04,Metro,3769,3459,310,3342,117,812,678,134,636,42,Metro,2022-07-14
2021-03-04,Northeast,947,527,420,522,5,114,68,46,63,5,Greater MN,2022-07-14
2021-03-04,Northwest,327,155,172,151,4,30,15,15,15,0,Greater MN,2022-07-14
2021-03-04,South Central,376,213,163,195,18,24,7,17,5,2,Greater MN,2022-07-14
2021-03-04,Southeast,1272,912,360,902,10,252,167,85,164,3,Greater MN,2022-07-14
2021-03-04,Southwest,366,113,253,113,0,14,3,11,3,0,Greater MN,2022-07-14
2021-03-04,State,8091,6096,1995,5929,167,1371,1009,362,952,57,State,2022-07-14
2021-03-04,West Central,208,89,119,89,0,20,6,14,6,0,Greater MN,2022-07-14
2022-03-04,Central,653,589,64,534,55,109,84,25,74,10,Greater MN,2022-07-14
2022-03-04,Metro,4058,3857,201,3642,215,785,677,108,649,28,Metro,2022-07-14
2022-03-04,Northeast,774,517,257,495,22,102,78,24,67,11,Greater MN,2022-07-14
2022-03-04,Northwest,238,136,102,126,10,26,18,8,14,4,Greater MN,2022-07-14
2022-03-04,South Central,324,218,106,204,14,22,7,15,6,1,Greater MN,2022-07-14
2022-03-04,Southeast,1294,1069,225,1038,31,255,183,72,179,4,Greater MN,2022-07-14
2022-03-04,Southwest,315,118,197,114,4,13,3,10,2,1,Greater MN,2022-07-14
2022-03-04,State,7810,6604,1206,6246,358,1323,1057,266,997,60,State,2022-07-14
2022-03-04,West Central,154,100,54,93,7,11,7,4,6,1,Greater MN,2022-07-14
2021-03-05,Central,839,611,228,594,17,104,68,36,63,5,Greater MN,2022-07-14
2021-03-05,Metro,3810,3489,321,3383,106,829,668,161,630,38,Metro,2022-07-14
2021-03-05,Northeast,947,514,433,506,8,114,72,42,68,4,Greater MN,2022-07-14
2021-03-05,Northwest,328,151,177,147,4,29,14,15,12,2,Greater MN,2022-07-14
2021-03-05,South Central,372,198,174,179,19,24,6,18,5,1,Greater MN,2022-07-14
2021-03-05,Southeast,1277,920,357,911,9,254,169,85,166,3,Greater MN,2022-07-14
2021-03-05,Southwest,367,136,231,136,0,15,3,12,3,0,Greater MN,2022-07-14
2021-03-05,State,8148,6095,2053,5932,163,1389,1007,382,954,53,State,2022-07-14
2021-03-05,West Central,208,76,132,76,0,20,7,13,7,0,Greater MN,2022-07-14
2022-03-05,Central,637,560,77,509,51,107,81,26,74,7,Greater MN,2022-07-14
2022-03-05,Metro,3969,3780,189,3593,187,773,662,111,641,21,Metro,2022-07-14
2022-03-05,Northeast,774,459,315,442,17,102,78,24,68,10,Greater MN,2022-07-14
2022-03-05,Northwest,236,144,92,132,12,25,10,15,8,2,Greater MN,2022-07-14
2022-03-05,South Central,317,206,111,196,10,22,7,15,6,1,Greater MN,2022-07-14
2022-03-05,Southeast,1293,1028,265,1000,28,255,180,75,176,4,Greater MN,2022-07-14
2022-03-05,Southwest,314,101,213,97,4,13,3,10,2,1,Greater MN,2022-07-14
2022-03-05,State,7692,6375,1317,6060,315,1308,1028,280,981,47,State,2022-07-14
2022-03-05,West Central,152,97,55,91,6,11,7,4,6,1,Greater MN,2022-07-14
2021-03-06,Central,806,582,224,564,18,102,64,38,60,4,Greater MN,2022-07-14
2021-03-06,Metro,3701,3353,348,3237,116,838,681,157,656,25,Metro,2022-07-14
2021-03-06,Northeast,949,479,470,468,11,117,78,39,74,4,Greater MN,2022-07-14
2021-03-06,Northwest,329,152,177,148,4,29,11,18,10,1,Greater MN,2022-07-14
2021-03-06,South Central,373,167,206,151,16,24,10,14,9,1,Greater MN,2022-07-14
2021-03-06,Southeast,1273,852,421,845,7,253,173,80,171,2,Greater MN,2022-07-14
2021-03-06,Southwest,362,124,238,124,0,16,2,14,2,0,Greater MN,2022-07-14
2021-03-06,State,8001,5776,2225,5603,173,1399,1025,374,988,37,State,2022-07-14
2021-03-06,West Central,208,67,141,66,1,20,6,14,6,0,Greater MN,2022-07-14
2022-03-06,Central,634,553,81,508,45,101,78,23,71,7,Greater MN,2022-07-14
2022-03-06,Metro,3881,3669,212,3478,191,765,643,122,622,21,Metro,2022-07-14
2022-03-06,Northeast,772,481,291,463,18,102,72,30,61,11,Greater MN,2022-07-14
2022-03-06,Northwest,236,139,97,128,11,25,13,12,10,3,Greater MN,2022-07-14
2022-03-06,South Central,319,190,129,179,11,23,11,12,9,2,Greater MN,2022-07-14
2022-03-06,Southeast,1283,981,302,949,32,257,176,81,172,4,Greater MN,2022-07-14
2022-03-06,Southwest,315,101,214,97,4,11,1,10,0,1,Greater MN,2022-07-14
2022-03-06,State,7594,6206,1388,5889,317,1295,999,296,949,50,State,2022-07-14
2022-03-06,West Central,154,92,62,87,5,11,5,6,4,1,Greater MN,2022-07-14
2021-03-07,Central,761,513,248,494,19,90,60,30,55,5,Greater MN,2022-07-14
2021-03-07,Metro,3627,3196,431,3089,107,811,637,174,602,35,Metro,2022-07-14
2021-03-07,Northeast,955,479,476,467,12,118,71,47,69,2,Greater MN,2022-07-14
2021-03-07,Northwest,329,163,166,159,4,29,12,17,11,1,Greater MN,2022-07-14
2021-03-07,South Central,369,176,193,155,21,24,7,17,6,1,Greater MN,2022-07-14
2021-03-07,Southeast,1267,824,443,813,11,254,142,112,140,2,Greater MN,2022-07-14
2021-03-07,Southwest,361,121,240,121,0,15,2,13,2,0,Greater MN,2022-07-14
2021-03-07,State,7877,5533,2344,5356,177,1361,935,426,889,46,State,2022-07-14
2021-03-07,West Central,208,61,147,58,3,20,4,16,4,0,Greater MN,2022-07-14
2022-03-07,Central,643,574,69,520,54,97,73,24,70,3,Greater MN,2022-07-14
2022-03-07,Metro,3843,3631,212,3438,193,774,646,128,622,24,Metro,2022-07-14
2022-03-07,Northeast,766,505,261,486,19,101,77,24,67,10,Greater MN,2022-07-14
2022-03-07,Northwest,236,135,101,125,10,25,11,14,8,3,Greater MN,2022-07-14
2022-03-07,South Central,319,209,110,198,11,22,10,12,9,1,Greater MN,2022-07-14
2022-03-07,Southeast,1287,955,332,931,24,256,148,108,144,4,Greater MN,2022-07-14
2022-03-07,Southwest,314,108,206,103,5,11,1,10,0,1,Greater MN,2022-07-14
2022-03-07,State,7568,6214,1354,5893,321,1295,972,323,925,47,State,2022-07-14
2022-03-07,West Central,160,97,63,92,5,9,6,3,5,1,Greater MN,2022-07-14
2021-03-08,Central,779,535,244,517,18,92,56,36,54,2,Greater MN,2022-07-14
2021-03-08,Metro,3577,3108,469,2997,111,800,632,168,594,38,Metro,2022-07-14
2021-03-08,Northeast,958,492,466,480,12,114,71,43,69,2,Greater MN,2022-07-14
2021-03-08,Northwest,329,162,167,158,4,29,13,16,12,1,Greater MN,2022-07-14
2021-03-08,South Central,372,180,192,161,19,24,8,16,5,3,Greater MN,2022-07-14
2021-03-08,Southeast,1256,794,462,780,14,253,142,111,139,3,Greater MN,2022-07-14
2021-03-08,Southwest,367,113,254,113,0,15,2,13,2,0,Greater MN,2022-07-14
2021-03-08,State,7846,5463,2383,5282,181,1347,930,417,880,50,State,2022-07-14
2021-03-08,West Central,208,79,129,76,3,20,6,14,5,1,Greater MN,2022-07-14
2022-03-08,Central,674,611,63,562,49,108,84,24,81,3,Greater MN,2022-07-14
2022-03-08,Metro,4020,3760,260,3579,181,780,669,111,642,27,Metro,2022-07-14
2022-03-08,Northeast,763,515,248,497,18,104,82,22,71,11,Greater MN,2022-07-14
2022-03-08,Northwest,238,151,87,141,10,25,19,6,15,4,Greater MN,2022-07-14
2022-03-08,South Central,321,215,106,208,7,22,10,12,9,1,Greater MN,2022-07-14
2022-03-08,Southeast,1285,1038,247,1007,31,256,165,91,161,4,Greater MN,2022-07-14
2022-03-08,Southwest,316,113,203,107,6,12,2,10,1,1,Greater MN,2022-07-14
2022-03-08,State,7781,6501,1280,6193,308,1316,1037,279,986,51,State,2022-07-14
2022-03-08,West Central,164,98,66,92,6,9,6,3,6,0,Greater MN,2022-07-14
2021-03-09,Central,815,579,236,570,9,96,59,37,53,6,Greater MN,2022-07-14
2021-03-09,Metro,3734,3424,310,3304,120,817,657,160,614,43,Metro,2022-07-14
2021-03-09,Northeast,954,519,435,509,10,114,80,34,77,3,Greater MN,2022-07-14
2021-03-09,Northwest,329,166,163,162,4,29,14,15,12,2,Greater MN,2022-07-14
2021-03-09,South Central,370,193,177,173,20,24,6,18,4,2,Greater MN,2022-07-14
2021-03-09,Southeast,1264,875,389,863,12,254,158,96,151,7,Greater MN,2022-07-14
2021-03-09,Southwest,379,125,254,123,2,13,1,12,1,0,Greater MN,2022-07-14
2021-03-09,State,8053,5976,2077,5797,179,1367,985,382,921,64,State,2022-07-14
2021-03-09,West Central,208,95,113,93,2,20,10,10,9,1,Greater MN,2022-07-14
2022-03-09,Central,717,642,75,602,40,112,89,23,86,3,Greater MN,2022-07-14
2022-03-09,Metro,4283,4009,274,3830,179,782,678,104,653,25,Metro,2022-07-14
2022-03-09,Northeast,772,550,222,528,22,102,75,27,65,10,Greater MN,2022-07-14
2022-03-09,Northwest,252,162,90,151,11,26,16,10,12,4,Greater MN,2022-07-14
2022-03-09,South Central,316,209,107,202,7,23,11,12,10,1,Greater MN,2022-07-14
2022-03-09,Southeast,1307,1087,220,1062,25,257,176,81,172,4,Greater MN,2022-07-14
2022-03-09,Southwest,331,134,197,129,5,13,4,9,2,2,Greater MN,2022-07-14
2022-03-09,State,8170,6923,1247,6630,293,1324,1055,269,1006,49,State,2022-07-14
2022-03-09,West Central,192,130,62,126,4,9,6,3,6,0,Greater MN,2022-07-14
2021-03-10,Central,859,608,251,596,12,102,65,37,58,7,Greater MN,2022-07-14
2021-03-10,Metro,3942,3583,359,3474,109,821,666,155,623,43,Metro,2022-07-14
2021-03-10,Northeast,958,551,407,540,11,114,84,30,80,4,Greater MN,2022-07-14
2021-03-10,Northwest,344,195,149,192,3,29,10,19,8,2,Greater MN,2022-07-14
2021-03-10,South Central,371,194,177,177,17,24,6,18,4,2,Greater MN,2022-07-14
2021-03-10,Southeast,1282,923,359,907,16,250,153,97,149,4,Greater MN,2022-07-14
2021-03-10,Southwest,388,140,248,137,3,15,1,14,1,0,Greater MN,2022-07-14
2021-03-10,State,8384,6321,2063,6148,173,1375,996,379,933,63,State,2022-07-14
2021-03-10,West Central,240,127,113,125,2,20,11,9,10,1,Greater MN,2022-07-14
2022-03-10,Central,683,582,101,555,27,107,80,27,77,3,Greater MN,2022-07-14
2022-03-10,Metro,4073,3805,268,3632,173,766,649,117,627,22,Metro,2022-07-14
2022-03-10,Northeast,778,524,254,503,21,104,72,32,64,8,Greater MN,2022-07-14
2022-03-10,Northwest,236,159,77,149,10,25,13,12,11,2,Greater MN,2022-07-14
2022-03-10,South Central,321,222,99,212,10,22,10,12,9,1,Greater MN,2022-07-14
2022-03-10,Southeast,1294,1067,227,1042,25,261,177,84,174,3,Greater MN,2022-07-14
2022-03-10,Southwest,307,119,188,116,3,13,4,9,2,2,Greater MN,2022-07-14
2022-03-10,State,7843,6570,1273,6298,272,1306,1010,296,969,41,State,2022-07-14
2022-03-10,West Central,151,92,59,89,3,8,5,3,5,0,Greater MN,2022-07-14
2021-03-11,Central,822,572,250,560,12,99,62,37,53,9,Greater MN,2022-07-14
2021-03-11,Metro,3782,3474,308,3366,108,806,671,135,628,43,Metro,2022-07-14
2021-03-11,Northeast,951,536,415,524,12,114,81,33,78,3,Greater MN,2022-07-14
2021-03-11,Northwest,328,167,161,162,5,29,14,15,12,2,Greater MN,2022-07-14
2021-03-11,South Central,372,197,175,183,14,25,9,16,6,3,Greater MN,2022-07-14
2021-03-11,Southeast,1262,940,322,923,17,255,157,98,152,5,Greater MN,2022-07-14
2021-03-11,Southwest,381,146,235,140,6,14,1,13,1,0,Greater MN,2022-07-14
2021-03-11,State,8106,6129,1977,5954,175,1362,1006,356,940,66,State,2022-07-14
2021-03-11,West Central,208,97,111,96,1,20,11,9,10,1,Greater MN,2022-07-14
2022-03-11,Central,656,560,96,534,26,101,72,29,69,3,Greater MN,2022-07-14
2022-03-11,Metro,4032,3738,294,3571,167,760,637,123,613,24,Metro,2022-07-14
2022-03-11,Northeast,784,541,243,525,16,111,76,35,70,6,Greater MN,2022-07-14
2022-03-11,Northwest,233,142,91,131,11,25,12,13,11,1,Greater MN,2022-07-14
2022-03-11,South Central,319,213,106,204,9,23,12,11,11,1,Greater MN,2022-07-14
2022-03-11,Southeast,1280,1056,224,1029,27,262,182,80,179,3,Greater MN,2022-07-14
2022-03-11,Southwest,304,103,201,102,1,13,4,9,3,1,Greater MN,2022-07-14
2022-03-11,State,7759,6440,1319,6182,258,1304,1001,303,961,40,State,2022-07-14
2022-03-11,West Central,151,87,64,86,1,9,6,3,5,1,Greater MN,2022-07-14
2021-03-12,Central,810,564,246,550,14,101,64,37,54,10,Greater MN,2022-07-14
2021-03-12,Metro,3840,3535,305,3414,121,815,675,140,633,42,Metro,2022-07-14
2021-03-12,Northeast,943,518,425,504,14,114,73,41,72,1,Greater MN,2022-07-14
2021-03-12,Northwest,328,172,156,165,7,29,12,17,9,3,Greater MN,2022-07-14
2021-03-12,South Central,373,208,165,196,12,24,8,16,6,2,Greater MN,2022-07-14
2021-03-12,Southeast,1278,988,290,966,22,256,158,98,153,5,Greater MN,2022-07-14
2021-03-12,Southwest,379,138,241,132,6,13,2,11,2,0,Greater MN,2022-07-14
2021-03-12,State,8159,6217,1942,6019,198,1372,996,376,933,63,State,2022-07-14
2021-03-12,West Central,208,94,114,92,2,20,4,16,4,0,Greater MN,2022-07-14
2022-03-12,Central,663,552,111,523,29,106,78,28,75,3,Greater MN,2022-07-14
2022-03-12,Metro,3987,3721,266,3555,166,752,632,120,608,24,Metro,2022-07-14
2022-03-12,Northeast,772,506,266,488,18,111,81,30,76,5,Greater MN,2022-07-14
2022-03-12,Northwest,232,138,94,126,12,25,13,12,12,1,Greater MN,2022-07-14
2022-03-12,South Central,309,202,107,194,8,22,10,12,10,0,Greater MN,2022-07-14
2022-03-12,Southeast,1302,1068,234,1045,23,262,177,85,172,5,Greater MN,2022-07-14
2022-03-12,Southwest,308,110,198,110,0,11,1,10,1,0,Greater MN,2022-07-14
2022-03-12,State,7722,6377,1345,6119,258,1297,997,300,959,38,State,2022-07-14
2022-03-12,West Central,149,80,69,78,2,8,5,3,5,0,Greater MN,2022-07-14
2021-03-13,Central,818,572,246,551,21,96,58,38,51,7,Greater MN,2022-07-14
2021-03-13,Metro,3712,3343,369,3232,111,820,658,162,617,41,Metro,2022-07-14
2021-03-13,Northeast,948,476,472,458,18,114,69,45,68,1,Greater MN,2022-07-14
2021-03-13,Northwest,328,164,164,158,6,29,14,15,11,3,Greater MN,2022-07-14
2021-03-13,South Central,371,199,172,185,14,24,8,16,6,2,Greater MN,2022-07-14
2021-03-13,Southeast,1269,928,341,908,20,253,163,90,156,7,Greater MN,2022-07-14
2021-03-13,Southwest,373,126,247,124,2,14,0,14,0,0,Greater MN,2022-07-14
2021-03-13,State,8027,5882,2145,5688,194,1370,977,393,916,61,State,2022-07-14
2021-03-13,West Central,208,74,134,72,2,20,7,13,7,0,Greater MN,2022-07-14
2022-03-13,Central,671,557,114,533,24,99,69,30,65,4,Greater MN,2022-07-14
2022-03-13,Metro,3831,3577,254,3402,175,760,616,144,593,23,Metro,2022-07-14
2022-03-13,Northeast,777,504,273,486,18,110,80,30,74,6,Greater MN,2022-07-14
2022-03-13,Northwest,236,142,94,131,11,25,13,12,10,3,Greater MN,2022-07-14
2022-03-13,South Central,310,195,115,189,6,22,7,15,7,0,Greater MN,2022-07-14
2022-03-13,Southeast,1291,968,323,948,20,261,170,91,165,5,Greater MN,2022-07-14
2022-03-13,Southwest,310,96,214,96,0,11,1,10,1,0,Greater MN,2022-07-14
2022-03-13,State,7570,6109,1461,5854,255,1297,960,337,919,41,State,2022-07-14
2022-03-13,West Central,144,70,74,69,1,9,4,5,4,0,Greater MN,2022-07-14
2021-03-14,Central,781,529,252,501,28,86,50,36,42,8,Greater MN,2022-07-14
2021-03-14,Metro,3567,3168,399,3057,111,790,611,179,575,36,Metro,2022-07-14
2021-03-14,Northeast,946,461,485,443,18,114,67,47,66,1,Greater MN,2022-07-14
2021-03-14,Northwest,327,165,162,159,6,30,16,14,11,5,Greater MN,2022-07-14
2021-03-14,South Central,372,193,179,179,14,24,10,14,8,2,Greater MN,2022-07-14
2021-03-14,Southeast,1278,846,432,826,20,254,141,113,134,7,Greater MN,2022-07-14
2021-03-14,Southwest,371,123,248,121,2,15,1,14,1,0,Greater MN,2022-07-14
2021-03-14,State,7850,5562,2288,5361,201,1333,904,429,845,59,State,2022-07-14
2021-03-14,West Central,208,77,131,75,2,20,8,12,8,0,Greater MN,2022-07-14
2022-03-14,Central,676,574,102,550,24,99,68,31,64,4,Greater MN,2022-07-14
2022-03-14,Metro,3837,3556,281,3382,174,741,613,128,586,27,Metro,2022-07-14
2022-03-14,Northeast,778,504,274,484,20,111,77,34,70,7,Greater MN,2022-07-14
2022-03-14,Northwest,236,142,94,134,8,25,12,13,10,2,Greater MN,2022-07-14
2022-03-14,South Central,315,209,106,202,7,22,11,11,11,0,Greater MN,2022-07-14
2022-03-14,Southeast,1301,976,325,953,23,263,174,89,167,7,Greater MN,2022-07-14
2022-03-14,Southwest,308,102,206,102,0,13,2,11,2,0,Greater MN,2022-07-14
2022-03-14,State,7598,6132,1466,5873,259,1284,963,321,916,47,State,2022-07-14
2022-03-14,West Central,147,69,78,66,3,10,6,4,6,0,Greater MN,2022-07-14
2021-03-15,Central,806,539,267,515,24,90,50,40,40,10,Greater MN,2022-07-14
2021-03-15,Metro,3542,3198,344,3084,114,784,611,173,569,42,Metro,2022-07-14
2021-03-15,Northeast,946,455,491,441,14,114,64,50,63,1,Greater MN,2022-07-14
2021-03-15,Northwest,328,168,160,164,4,29,14,15,10,4,Greater MN,2022-07-14
2021-03-15,South Central,370,194,176,181,13,24,10,14,8,2,Greater MN,2022-07-14
2021-03-15,Southeast,1274,829,445,810,19,253,130,123,125,5,Greater MN,2022-07-14
2021-03-15,Southwest,372,104,268,102,2,16,3,13,3,0,Greater MN,2022-07-14
2021-03-15,State,7846,5569,2277,5376,193,1330,890,440,826,64,State,2022-07-14
2021-03-15,West Central,208,82,126,79,3,20,8,12,8,0,Greater MN,2022-07-14
2022-03-15,Central,699,625,74,602,23,110,88,22,84,4,Greater MN,2022-07-14
2022-03-15,Metro,3987,3834,153,3667,167,760,632,128,607,25,Metro,2022-07-14
2022-03-15,Northeast,767,502,265,486,16,105,75,30,68,7,Greater MN,2022-07-14
2022-03-15,Northwest,235,138,97,132,6,25,13,12,10,3,Greater MN,2022-07-14
2022-03-15,South Central,321,211,110,204,7,22,10,12,10,0,Greater MN,2022-07-14
2022-03-15,Southeast,1291,1042,249,1019,23,263,193,70,188,5,Greater MN,2022-07-14
2022-03-15,Southwest,305,105,200,105,0,11,1,10,1,0,Greater MN,2022-07-14
2022-03-15,State,7755,6537,1218,6292,245,1305,1017,288,973,44,State,2022-07-14
2022-03-15,West Central,150,80,70,77,3,9,5,4,5,0,Greater MN,2022-07-14
2021-03-16,Central,830,599,231,575,24,98,63,35,50,13,Greater MN,2022-07-14
2021-03-16,Metro,3765,3405,360,3275,130,791,636,155,594,42,Metro,2022-07-14
2021-03-16,Northeast,952,478,474,460,18,114,72,42,70,2,Greater MN,2022-07-14
2021-03-16,Northwest,329,175,154,171,4,29,12,17,9,3,Greater MN,2022-07-14
2021-03-16,South Central,373,218,155,204,14,24,9,15,7,2,Greater MN,2022-07-14
2021-03-16,Southeast,1274,903,371,885,18,255,149,106,144,5,Greater MN,2022-07-14
2021-03-16,Southwest,371,110,261,108,2,14,3,11,3,0,Greater MN,2022-07-14
2021-03-16,State,8085,5975,2110,5761,214,1342,950,392,883,67,State,2022-07-14
2021-03-16,West Central,191,87,104,83,4,17,6,11,6,0,Greater MN,2022-07-14
2022-03-16,Central,752,673,79,649,24,104,78,26,74,4,Greater MN,2022-07-14
2022-03-16,Metro,4184,4025,159,3870,155,770,647,123,627,20,Metro,2022-07-14
2022-03-16,Northeast,766,506,260,489,17,107,79,28,73,6,Greater MN,2022-07-14
2022-03-16,Northwest,258,143,115,135,8,25,12,13,11,1,Greater MN,2022-07-14
2022-03-16,South Central,321,220,101,217,3,22,9,13,9,0,Greater MN,2022-07-14
2022-03-16,Southeast,1301,1086,215,1068,18,256,195,61,190,5,Greater MN,2022-07-14
2022-03-16,Southwest,312,110,202,109,1,10,0,10,0,0,Greater MN,2022-07-14
2022-03-16,State,8080,6883,1197,6654,229,1303,1023,280,987,36,State,2022-07-14
2022-03-16,West Central,186,120,66,117,3,9,3,6,3,0,Greater MN,2022-07-14
2021-03-17,Central,878,656,222,628,28,97,61,36,49,12,Greater MN,2022-07-14
2021-03-17,Metro,4045,3689,356,3556,133,821,660,161,613,47,Metro,2022-07-14
2021-03-17,Northeast,953,536,417,518,18,114,85,29,83,2,Greater MN,2022-07-14
2021-03-17,Northwest,345,171,174,169,2,29,9,20,6,3,Greater MN,2022-07-14
2021-03-17,South Central,369,214,155,201,13,24,7,17,5,2,Greater MN,2022-07-14
2021-03-17,Southeast,1275,967,308,948,19,252,143,109,135,8,Greater MN,2022-07-14
2021-03-17,Southwest,386,125,261,122,3,15,2,13,2,0,Greater MN,2022-07-14
2021-03-17,State,8491,6471,2020,6248,223,1372,976,396,902,74,State,2022-07-14
2021-03-17,West Central,240,113,127,106,7,20,9,11,9,0,Greater MN,2022-07-14
2022-03-17,Central,706,620,86,597,23,103,75,28,70,5,Greater MN,2022-07-14
2022-03-17,Metro,4020,3882,138,3719,163,756,636,120,608,28,Metro,2022-07-14
2022-03-17,Northeast,769,526,243,511,15,107,83,24,76,7,Greater MN,2022-07-14
2022-03-17,Northwest,237,124,113,116,8,23,13,10,12,1,Greater MN,2022-07-14
2022-03-17,South Central,319,213,106,210,3,22,9,13,9,0,Greater MN,2022-07-14
2022-03-17,Southeast,1289,1091,198,1068,23,255,198,57,195,3,Greater MN,2022-07-14
2022-03-17,Southwest,320,136,184,135,1,11,1,10,0,1,Greater MN,2022-07-14
2022-03-17,State,7813,6696,1117,6457,239,1287,1021,266,976,45,State,2022-07-14
2022-03-17,West Central,153,104,49,101,3,10,6,4,6,0,Greater MN,2022-07-14
2021-03-18,Central,841,594,247,561,33,97,58,39,48,10,Greater MN,2022-07-14
2021-03-18,Metro,3916,3557,359,3416,141,828,682,146,632,50,Metro,2022-07-14
2021-03-18,Northeast,954,525,429,510,15,114,81,33,78,3,Greater MN,2022-07-14
2021-03-18,Northwest,329,152,177,150,2,29,11,18,7,4,Greater MN,2022-07-14
2021-03-18,South Central,372,216,156,202,14,24,7,17,6,1,Greater MN,2022-07-14
2021-03-18,Southeast,1276,975,301,951,24,249,141,108,135,6,Greater MN,2022-07-14
2021-03-18,Southwest,374,125,249,121,4,15,3,12,3,0,Greater MN,2022-07-14
2021-03-18,State,8270,6255,2015,6013,242,1376,989,387,915,74,State,2022-07-14
2021-03-18,West Central,208,111,97,102,9,20,6,14,6,0,Greater MN,2022-07-14
2022-03-18,Central,679,593,86,572,21,105,85,20,77,8,Greater MN,2022-07-14
2022-03-18,Metro,4044,3859,185,3710,149,757,654,103,626,28,Metro,2022-07-14
2022-03-18,Northeast,767,533,234,514,19,106,82,24,76,6,Greater MN,2022-07-14
2022-03-18,Northwest,238,128,110,119,9,23,11,12,10,1,Greater MN,2022-07-14
2022-03-18,South Central,316,218,98,212,6,22,9,13,9,0,Greater MN,2022-07-14
2022-03-18,Southeast,1302,1102,200,1076,26,258,202,56,199,3,Greater MN,2022-07-14
2022-03-18,Southwest,317,136,181,134,2,11,1,10,1,0,Greater MN,2022-07-14
2022-03-18,State,7823,6681,1142,6446,235,1290,1046,244,1000,46,State,2022-07-14
2022-03-18,West Central,160,112,48,109,3,8,2,6,2,0,Greater MN,2022-07-14
2021-03-19,Central,828,595,233,563,32,100,69,31,57,12,Greater MN,2022-07-14
2021-03-19,Metro,3850,3517,333,3370,147,830,696,134,645,51,Metro,2022-07-14
2021-03-19,Northeast,952,516,436,500,16,114,73,41,70,3,Greater MN,2022-07-14
2021-03-19,Northwest,330,155,175,152,3,29,11,18,9,2,Greater MN,2022-07-14
2021-03-19,South Central,370,198,172,183,15,25,9,16,7,2,Greater MN,2022-07-14
2021-03-19,Southeast,1282,995,287,970,25,250,145,105,139,6,Greater MN,2022-07-14
2021-03-19,Southwest,367,128,239,124,4,15,2,13,2,0,Greater MN,2022-07-14
2021-03-19,State,8187,6216,1971,5964,252,1383,1012,371,935,77,State,2022-07-14
2021-03-19,West Central,208,112,96,102,10,20,7,13,6,1,Greater MN,2022-07-14
2022-03-19,Central,665,584,81,563,21,104,76,28,71,5,Greater MN,2022-07-14
2022-03-19,Metro,3908,3683,225,3538,145,736,630,106,601,29,Metro,2022-07-14
2022-03-19,Northeast,767,486,281,470,16,105,79,26,74,5,Greater MN,2022-07-14
2022-03-19,Northwest,237,122,115,115,7,23,10,13,10,0,Greater MN,2022-07-14
2022-03-19,South Central,319,204,115,202,2,22,4,18,4,0,Greater MN,2022-07-14
2022-03-19,Southeast,1305,1068,237,1045,23,258,183,75,180,3,Greater MN,2022-07-14
2022-03-19,Southwest,311,131,180,129,2,12,2,10,2,0,Greater MN,2022-07-14
2022-03-19,State,7665,6381,1284,6163,218,1270,987,283,945,42,State,2022-07-14
2022-03-19,West Central,153,103,50,101,2,10,3,7,3,0,Greater MN,2022-07-14
2021-03-20,Central,820,572,248,546,26,101,74,27,60,14,Greater MN,2022-07-14
2021-03-20,Metro,3777,3401,376,3258,143,826,682,144,634,48,Metro,2022-07-14
2021-03-20,Northeast,946,481,465,465,16,114,85,29,82,3,Greater MN,2022-07-14
2021-03-20,Northwest,328,139,189,137,2,29,14,15,11,3,Greater MN,2022-07-14
2021-03-20,South Central,372,181,191,164,17,24,9,15,7,2,Greater MN,2022-07-14
2021-03-20,Southeast,1283,970,313,942,28,255,142,113,137,5,Greater MN,2022-07-14
2021-03-20,Southwest,358,127,231,122,5,13,2,11,1,1,Greater MN,2022-07-14
2021-03-20,State,8092,5950,2142,5704,246,1382,1014,368,936,78,State,2022-07-14
2021-03-20,West Central,208,79,129,70,9,20,6,14,4,2,Greater MN,2022-07-14
2022-03-20,Central,650,556,94,537,19,101,74,27,69,5,Greater MN,2022-07-14
2022-03-20,Metro,3922,3674,248,3532,142,734,624,110,598,26,Metro,2022-07-14
2022-03-20,Northeast,768,488,280,470,18,105,73,32,68,5,Greater MN,2022-07-14
2022-03-20,Northwest,235,122,113,115,7,24,13,11,12,1,Greater MN,2022-07-14
2022-03-20,South Central,320,211,109,208,3,22,5,17,5,0,Greater MN,2022-07-14
2022-03-20,Southeast,1300,1000,300,977,23,253,166,87,165,1,Greater MN,2022-07-14
2022-03-20,Southwest,311,115,196,114,1,10,1,9,1,0,Greater MN,2022-07-14
2022-03-20,State,7658,6257,1401,6042,215,1257,959,298,921,38,State,2022-07-14
2022-03-20,West Central,152,91,61,89,2,8,3,5,3,0,Greater MN,2022-07-14
2021-03-21,Central,811,562,249,539,23,103,71,32,57,14,Greater MN,2022-07-14
2021-03-21,Metro,3664,3254,410,3117,137,814,666,148,617,49,Metro,2022-07-14
2021-03-21,Northeast,943,478,465,461,17,114,77,37,74,3,Greater MN,2022-07-14
2021-03-21,Northwest,329,142,187,139,3,29,14,15,11,3,Greater MN,2022-07-14
2021-03-21,South Central,372,192,180,172,20,24,9,15,7,2,Greater MN,2022-07-14
2021-03-21,Southeast,1274,866,408,839,27,257,124,133,119,5,Greater MN,2022-07-14
2021-03-21,Southwest,358,120,238,115,5,14,3,11,2,1,Greater MN,2022-07-14
2021-03-21,State,7959,5682,2277,5441,241,1375,970,405,892,78,State,2022-07-14
2021-03-21,West Central,208,68,140,59,9,20,6,14,5,1,Greater MN,2022-07-14
2022-03-21,Central,636,558,78,542,16,95,68,27,64,4,Greater MN,2022-07-14
2022-03-21,Metro,3870,3673,197,3526,147,724,609,115,586,23,Metro,2022-07-14
2022-03-21,Northeast,771,500,271,482,18,95,70,25,65,5,Greater MN,2022-07-14
2022-03-21,Northwest,240,139,101,133,6,24,12,12,11,1,Greater MN,2022-07-14
2022-03-21,South Central,318,219,99,217,2,22,10,12,10,0,Greater MN,2022-07-14
2022-03-21,Southeast,1294,981,313,958,23,249,172,77,170,2,Greater MN,2022-07-14
2022-03-21,Southwest,316,119,197,118,1,11,3,8,3,0,Greater MN,2022-07-14
2022-03-21,State,7592,6278,1314,6063,215,1230,949,281,914,35,State,2022-07-14
2022-03-21,West Central,147,89,58,87,2,10,5,5,5,0,Greater MN,2022-07-14
2021-03-22,Central,814,576,238,548,28,101,63,38,52,11,Greater MN,2022-07-14
2021-03-22,Metro,3635,3226,409,3094,132,802,643,159,583,60,Metro,2022-07-14
2021-03-22,Northeast,952,521,431,502,19,114,82,32,78,4,Greater MN,2022-07-14
2021-03-22,Northwest,329,143,186,141,2,29,10,19,7,3,Greater MN,2022-07-14
2021-03-22,South Central,374,201,173,182,19,24,9,15,8,1,Greater MN,2022-07-14
2021-03-22,Southeast,1271,839,432,814,25,250,117,133,111,6,Greater MN,2022-07-14
2021-03-22,Southwest,367,118,249,113,5,15,4,11,3,1,Greater MN,2022-07-14
2021-03-22,State,7950,5705,2245,5468,237,1355,931,424,844,87,State,2022-07-14
2021-03-22,West Central,208,81,127,74,7,20,3,17,2,1,Greater MN,2022-07-14
2022-03-22,Central,645,577,68,562,15,101,76,25,74,2,Greater MN,2022-07-14
2022-03-22,Metro,3995,3825,170,3687,138,758,643,115,619,24,Metro,2022-07-14
2022-03-22,Northeast,772,506,266,492,14,94,65,29,61,4,Greater MN,2022-07-14
2022-03-22,Northwest,243,167,76,159,8,25,17,8,16,1,Greater MN,2022-07-14
2022-03-22,South Central,320,212,108,209,3,22,10,12,10,0,Greater MN,2022-07-14
2022-03-22,Southeast,1282,1044,238,1024,20,258,185,73,182,3,Greater MN,2022-07-14
2022-03-22,Southwest,317,125,192,124,1,12,2,10,2,0,Greater MN,2022-07-14
2022-03-22,State,7730,6555,1175,6354,201,1278,1000,278,966,34,State,2022-07-14
2022-03-22,West Central,156,99,57,97,2,8,2,6,2,0,Greater MN,2022-07-14
2021-03-23,Central,829,605,224,575,30,96,58,38,45,13,Greater MN,2022-07-14
2021-03-23,Metro,3788,3374,414,3233,141,804,663,141,597,66,Metro,2022-07-14
2021-03-23,Northeast,946,529,417,511,18,114,82,32,79,3,Greater MN,2022-07-14
2021-03-23,Northwest,328,151,177,147,4,29,11,18,8,3,Greater MN,2022-07-14
2021-03-23,South Central,372,208,164,193,15,24,9,15,8,1,Greater MN,2022-07-14
2021-03-23,Southeast,1274,954,320,931,23,247,131,116,127,4,Greater MN,2022-07-14
2021-03-23,Southwest,369,130,239,127,3,15,3,12,1,2,Greater MN,2022-07-14
2021-03-23,State,8114,6047,2067,5808,239,1349,963,386,870,93,State,2022-07-14
2021-03-23,West Central,208,96,112,91,5,20,6,14,5,1,Greater MN,2022-07-14
2022-03-23,Central,688,606,82,596,10,100,74,26,73,1,Greater MN,2022-07-14
2022-03-23,Metro,4210,3999,211,3859,140,756,640,116,615,25,Metro,2022-07-14
2022-03-23,Northeast,758,518,240,507,11,103,74,29,71,3,Greater MN,2022-07-14
2022-03-23,Northwest,261,176,85,169,7,24,15,9,14,1,Greater MN,2022-07-14
2022-03-23,South Central,318,225,93,220,5,23,10,13,10,0,Greater MN,2022-07-14
2022-03-23,Southeast,1315,1082,233,1066,16,260,196,64,192,4,Greater MN,2022-07-14
2022-03-23,Southwest,325,129,196,128,1,12,1,11,1,0,Greater MN,2022-07-14
2022-03-23,State,8062,6866,1196,6674,192,1286,1012,274,978,34,State,2022-07-14
2022-03-23,West Central,187,131,56,129,2,8,2,6,2,0,Greater MN,2022-07-14
2021-03-24,Central,855,637,218,609,28,97,63,34,47,16,Greater MN,2022-07-14
2021-03-24,Metro,4053,3690,363,3533,157,816,687,129,630,57,Metro,2022-07-14
2021-03-24,Northeast,947,564,383,539,25,114,79,35,77,2,Greater MN,2022-07-14
2021-03-24,Northwest,344,181,163,177,4,29,12,17,10,2,Greater MN,2022-07-14
2021-03-24,South Central,371,220,151,205,15,24,10,14,9,1,Greater MN,2022-07-14
2021-03-24,Southeast,1286,1014,272,993,21,250,139,111,136,3,Greater MN,2022-07-14
2021-03-24,Southwest,395,139,256,132,7,14,2,12,1,1,Greater MN,2022-07-14
2021-03-24,State,8491,6565,1926,6303,262,1364,998,366,915,83,State,2022-07-14
2021-03-24,West Central,240,120,120,115,5,20,6,14,5,1,Greater MN,2022-07-14
2022-03-24,Central,680,586,94,575,11,98,72,26,71,1,Greater MN,2022-07-14
2022-03-24,Metro,3986,3812,174,3678,134,750,635,115,613,22,Metro,2022-07-14
2022-03-24,Northeast,758,522,236,509,13,105,77,28,74,3,Greater MN,2022-07-14
2022-03-24,Northwest,244,151,93,145,6,25,13,12,12,1,Greater MN,2022-07-14
2022-03-24,South Central,330,235,95,230,5,22,11,11,11,0,Greater MN,2022-07-14
2022-03-24,Southeast,1288,1071,217,1054,17,258,195,63,193,2,Greater MN,2022-07-14
2022-03-24,Southwest,308,121,187,120,1,11,0,11,0,0,Greater MN,2022-07-14
2022-03-24,State,7746,6588,1158,6400,188,1278,1004,274,975,29,State,2022-07-14
2022-03-24,West Central,152,90,62,89,1,9,1,8,1,0,Greater MN,2022-07-14
2021-03-25,Central,824,598,226,564,34,104,63,41,45,18,Greater MN,2022-07-14
2021-03-25,Metro,3855,3555,300,3389,166,811,667,144,609,58,Metro,2022-07-14
2021-03-25,Northeast,948,556,392,534,22,114,77,37,75,2,Greater MN,2022-07-14
2021-03-25,Northwest,328,153,175,150,3,29,12,17,9,3,Greater MN,2022-07-14
2021-03-25,South Central,371,222,149,207,15,24,10,14,8,2,Greater MN,2022-07-14
2021-03-25,Southeast,1267,1001,266,981,20,250,138,112,136,2,Greater MN,2022-07-14
2021-03-25,Southwest,371,134,237,127,7,15,3,12,2,1,Greater MN,2022-07-14
2021-03-25,State,8172,6305,1867,6035,270,1367,976,391,889,87,State,2022-07-14
2021-03-25,West Central,208,86,122,83,3,20,6,14,5,1,Greater MN,2022-07-14
2022-03-25,Central,674,581,93,569,12,95,65,30,64,1,Greater MN,2022-07-14
2022-03-25,Metro,3985,3792,193,3672,120,747,631,116,608,23,Metro,2022-07-14
2022-03-25,Northeast,764,526,238,515,11,100,71,29,67,4,Greater MN,2022-07-14
2022-03-25,Northwest,244,160,84,155,5,25,11,14,10,1,Greater MN,2022-07-14
2022-03-25,South Central,322,225,97,218,7,22,10,12,10,0,Greater MN,2022-07-14
2022-03-25,Southeast,1294,1066,228,1051,15,261,202,59,201,1,Greater MN,2022-07-14
2022-03-25,Southwest,303,117,186,116,1,11,1,10,1,0,Greater MN,2022-07-14
2022-03-25,State,7734,6553,1181,6382,171,1270,995,275,965,30,State,2022-07-14
2022-03-25,West Central,148,86,62,86,0,9,4,5,4,0,Greater MN,2022-07-14
2021-03-26,Central,799,565,234,532,33,101,70,31,51,19,Greater MN,2022-07-14
2021-03-26,Metro,3862,3601,261,3432,169,819,672,147,610,62,Metro,2022-07-14
2021-03-26,Northeast,947,519,428,494,25,114,78,36,76,2,Greater MN,2022-07-14
2021-03-26,Northwest,328,150,178,147,3,29,15,14,11,4,Greater MN,2022-07-14
2021-03-26,South Central,373,207,166,195,12,24,7,17,6,1,Greater MN,2022-07-14
2021-03-26,Southeast,1280,980,300,961,19,250,147,103,144,3,Greater MN,2022-07-14
2021-03-26,Southwest,368,149,219,138,11,15,4,11,3,1,Greater MN,2022-07-14
2021-03-26,State,8165,6263,1902,5987,276,1372,998,374,906,92,State,2022-07-14
2021-03-26,West Central,208,92,116,88,4,20,5,15,5,0,Greater MN,2022-07-14
2022-03-26,Central,659,570,89,559,11,95,67,28,66,1,Greater MN,2022-07-14
2022-03-26,Metro,3895,3675,220,3552,123,749,637,112,613,24,Metro,2022-07-14
2022-03-26,Northeast,764,501,263,489,12,106,75,31,69,6,Greater MN,2022-07-14
2022-03-26,Northwest,235,142,93,137,5,25,12,13,11,1,Greater MN,2022-07-14
2022-03-26,South Central,306,205,101,201,4,22,10,12,9,1,Greater MN,2022-07-14
2022-03-26,Southeast,1293,1054,239,1038,16,256,194,62,192,2,Greater MN,2022-07-14
2022-03-26,Southwest,298,110,188,110,0,12,1,11,1,0,Greater MN,2022-07-14
2022-03-26,State,7597,6335,1262,6164,171,1276,1001,275,966,35,State,2022-07-14
2022-03-26,West Central,147,78,69,78,0,11,5,6,5,0,Greater MN,2022-07-14
2021-03-27,Central,807,554,253,519,35,95,63,32,47,16,Greater MN,2022-07-14
2021-03-27,Metro,3837,3530,307,3363,167,839,689,150,625,64,Metro,2022-07-14
2021-03-27,Northeast,956,492,464,472,20,114,77,37,74,3,Greater MN,2022-07-14
2021-03-27,Northwest,328,142,186,140,2,29,12,17,9,3,Greater MN,2022-07-14
2021-03-27,South Central,373,209,164,198,11,24,8,16,7,1,Greater MN,2022-07-14
2021-03-27,Southeast,1278,949,329,931,18,251,141,110,137,4,Greater MN,2022-07-14
2021-03-27,Southwest,360,133,227,124,9,14,4,10,3,1,Greater MN,2022-07-14
2021-03-27,State,8147,6075,2072,5811,264,1386,1000,386,908,92,State,2022-07-14
2021-03-27,West Central,208,66,142,64,2,20,6,14,6,0,Greater MN,2022-07-14
2022-03-27,Central,632,521,111,512,9,97,65,32,64,1,Greater MN,2022-07-14
2022-03-27,Metro,3770,3499,271,3377,122,728,602,126,581,21,Metro,2022-07-14
2022-03-27,Northeast,759,483,276,471,12,106,76,30,71,5,Greater MN,2022-07-14
2022-03-27,Northwest,245,135,110,130,5,25,12,13,12,0,Greater MN,2022-07-14
2022-03-27,South Central,306,188,118,184,4,22,9,13,8,1,Greater MN,2022-07-14
2022-03-27,Southeast,1282,949,333,930,19,255,173,82,171,2,Greater MN,2022-07-14
2022-03-27,Southwest,293,94,199,94,0,12,1,11,1,0,Greater MN,2022-07-14
2022-03-27,State,7433,5938,1495,5766,172,1256,942,314,912,30,State,2022-07-14
2022-03-27,West Central,146,69,77,68,1,11,4,7,4,0,Greater MN,2022-07-14
2021-03-28,Central,767,523,244,486,37,89,57,32,40,17,Greater MN,2022-07-14
2021-03-28,Metro,3656,3316,340,3152,164,817,673,144,612,61,Metro,2022-07-14
2021-03-28,Northeast,951,485,466,465,20,115,70,45,68,2,Greater MN,2022-07-14
2021-03-28,Northwest,328,127,201,125,2,29,9,20,6,3,Greater MN,2022-07-14
2021-03-28,South Central,375,195,180,189,6,24,10,14,9,1,Greater MN,2022-07-14
2021-03-28,Southeast,1278,884,394,866,18,250,132,118,128,4,Greater MN,2022-07-14
2021-03-28,Southwest,357,115,242,107,8,13,3,10,3,0,Greater MN,2022-07-14
2021-03-28,State,7912,5709,2203,5453,256,1365,959,406,871,88,State,2022-07-14
2021-03-28,West Central,200,64,136,63,1,28,5,23,5,0,Greater MN,2022-07-14
2022-03-28,Central,656,561,95,551,10,90,60,30,59,1,Greater MN,2022-07-14
2022-03-28,Metro,3799,3519,280,3403,116,720,583,137,563,20,Metro,2022-07-14
2022-03-28,Northeast,764,491,273,478,13,106,63,43,58,5,Greater MN,2022-07-14
2022-03-28,Northwest,242,135,107,131,4,25,17,8,17,0,Greater MN,2022-07-14
2022-03-28,South Central,312,190,122,187,3,22,9,13,8,1,Greater MN,2022-07-14
2022-03-28,Southeast,1278,941,337,922,19,257,156,101,154,2,Greater MN,2022-07-14
2022-03-28,Southwest,298,90,208,90,0,12,1,11,1,0,Greater MN,2022-07-14
2022-03-28,State,7499,5993,1506,5828,165,1243,893,350,864,29,State,2022-07-14
2022-03-28,West Central,150,66,84,66,0,11,4,7,4,0,Greater MN,2022-07-14
2021-03-29,Central,784,551,233,512,39,96,59,37,43,16,Greater MN,2022-07-14
2021-03-29,Metro,3603,3226,377,3053,173,815,657,158,594,63,Metro,2022-07-14
2021-03-29,Northeast,951,507,444,485,22,114,78,36,77,1,Greater MN,2022-07-14
2021-03-29,Northwest,328,118,210,115,3,29,12,17,7,5,Greater MN,2022-07-14
2021-03-29,South Central,375,193,182,186,7,24,9,15,9,0,Greater MN,2022-07-14
2021-03-29,Southeast,1264,861,403,844,17,254,130,124,127,3,Greater MN,2022-07-14
2021-03-29,Southwest,363,113,250,107,6,13,3,10,2,1,Greater MN,2022-07-14
2021-03-29,State,7876,5640,2236,5372,268,1365,955,410,866,89,State,2022-07-14
2021-03-29,West Central,208,71,137,70,1,20,7,13,7,0,Greater MN,2022-07-14
2022-03-29,Central,678,602,76,592,10,104,73,31,72,1,Greater MN,2022-07-14
2022-03-29,Metro,4039,3775,264,3666,109,740,612,128,590,22,Metro,2022-07-14
2022-03-29,Northeast,761,514,247,498,16,103,63,40,59,4,Greater MN,2022-07-14
2022-03-29,Northwest,237,138,99,134,4,23,16,7,16,0,Greater MN,2022-07-14
2022-03-29,South Central,319,222,97,218,4,22,9,13,7,2,Greater MN,2022-07-14
2022-03-29,Southeast,1283,1005,278,986,19,261,170,91,168,2,Greater MN,2022-07-14
2022-03-29,Southwest,307,99,208,98,1,13,2,11,2,0,Greater MN,2022-07-14
2022-03-29,State,7777,6430,1347,6267,163,1275,949,326,918,31,State,2022-07-14
2022-03-29,West Central,153,75,78,75,0,9,4,5,4,0,Greater MN,2022-07-14
2021-03-30,Central,851,665,186,630,35,100,62,38,46,16,Greater MN,2022-07-14
2021-03-30,Metro,3780,3474,306,3261,213,832,692,140,621,71,Metro,2022-07-14
2021-03-30,Northeast,952,571,381,547,24,114,80,34,78,2,Greater MN,2022-07-14
2021-03-30,Northwest,329,148,181,147,1,29,13,16,7,6,Greater MN,2022-07-14
2021-03-30,South Central,377,219,158,207,12,24,9,15,9,0,Greater MN,2022-07-14
2021-03-30,Southeast,1271,919,352,903,16,251,147,104,141,6,Greater MN,2022-07-14
2021-03-30,Southwest,378,137,241,131,6,14,3,11,2,1,Greater MN,2022-07-14
2021-03-30,State,8146,6207,1939,5898,309,1384,1014,370,912,102,State,2022-07-14
2021-03-30,West Central,208,74,134,72,2,20,8,12,8,0,Greater MN,2022-07-14
2022-03-30,Central,706,636,70,627,9,102,75,27,74,1,Greater MN,2022-07-14
2022-03-30,Metro,4198,3969,229,3868,101,739,623,116,602,21,Metro,2022-07-14
2022-03-30,Northeast,764,545,219,534,11,105,68,37,64,4,Greater MN,2022-07-14
2022-03-30,Northwest,256,159,97,155,4,25,17,8,17,0,Greater MN,2022-07-14
2022-03-30,South Central,317,220,97,213,7,22,10,12,9,1,Greater MN,2022-07-14
2022-03-30,Southeast,1279,1088,191,1065,23,256,170,86,168,2,Greater MN,2022-07-14
2022-03-30,Southwest,322,120,202,119,1,12,2,10,2,0,Greater MN,2022-07-14
2022-03-30,State,8028,6852,1176,6696,156,1271,969,302,940,29,State,2022-07-14
2022-03-30,West Central,186,115,71,115,0,10,4,6,4,0,Greater MN,2022-07-14
2021-03-31,Central,881,682,199,641,41,99,65,34,50,15,Greater MN,2022-07-14
2021-03-31,Metro,4044,3722,322,3507,215,846,704,142,631,73,Metro,2022-07-14
2021-03-31,Northeast,969,596,373,572,24,114,90,24,88,2,Greater MN,2022-07-14
2021-03-31,Northwest,344,176,168,173,3,29,14,15,8,6,Greater MN,2022-07-14
2021-03-31,South Central,375,216,159,206,10,24,9,15,9,0,Greater MN,2022-07-14
2021-03-31,Southeast,1307,990,317,977,13,248,158,90,149,9,Greater MN,2022-07-14
2021-03-31,Southwest,391,134,257,125,9,14,2,12,1,1,Greater MN,2022-07-14
2021-03-31,State,8551,6614,1937,6295,319,1394,1050,344,944,106,State,2022-07-14
2021-03-31,West Central,240,98,142,94,4,20,8,12,8,0,Greater MN,2022-07-14
2022-03-31,Central,665,588,77,577,11,99,79,20,78,1,Greater MN,2022-07-14
2022-03-31,Metro,4002,3816,186,3712,104,763,656,107,633,23,Metro,2022-07-14
2022-03-31,Northeast,792,511,281,500,11,113,74,39,70,4,Greater MN,2022-07-14
2022-03-31,Northwest,242,152,90,147,5,24,13,11,13,0,Greater MN,2022-07-14
2022-03-31,South Central,318,217,101,212,5,22,10,12,10,0,Greater MN,2022-07-14
2022-03-31,Southeast,1278,1071,207,1052,19,256,175,81,172,3,Greater MN,2022-07-14
2022-03-31,Southwest,311,110,201,108,2,13,3,10,3,0,Greater MN,2022-07-14
2022-03-31,State,7758,6547,1211,6389,158,1300,1015,285,984,31,State,2022-07-14
2022-03-31,West Central,150,82,68,81,1,10,5,5,5,0,Greater MN,2022-07-14
2021-04-01,Central,833,634,199,594,40,97,68,29,52,16,Greater MN,2022-07-14
2021-04-01,Metro,3827,3505,322,3282,223,850,687,163,611,76,Metro,2022-07-14
2021-04-01,Northeast,967,552,415,527,25,114,84,30,80,4,Greater MN,2022-07-14
2021-04-01,Northwest,328,148,180,146,2,29,12,17,6,6,Greater MN,2022-07-14
2021-04-01,South Central,378,224,154,212,12,24,9,15,9,0,Greater MN,2022-07-14
2021-04-01,Southeast,1279,956,323,939,17,249,158,91,148,10,Greater MN,2022-07-14
2021-04-01,Southwest,370,123,247,115,8,12,0,12,0,0,Greater MN,2022-07-14
2021-04-01,State,8190,6229,1961,5897,332,1395,1026,369,914,112,State,2022-07-14
2021-04-01,West Central,208,87,121,82,5,20,8,12,8,0,Greater MN,2022-07-14
2022-04-01,Central,673,608,65,596,12,105,86,19,85,1,Greater MN,2022-07-14
2022-04-01,Metro,3975,3756,219,3644,112,772,676,96,653,23,Metro,2022-07-14
2022-04-01,Northeast,772,492,280,479,13,105,69,36,66,3,Greater MN,2022-07-14
2022-04-01,Northwest,245,156,89,151,5,24,13,11,13,0,Greater MN,2022-07-14
2022-04-01,South Central,319,209,110,204,5,22,9,13,9,0,Greater MN,2022-07-14
2022-04-01,Southeast,1287,1044,243,1023,21,257,167,90,162,5,Greater MN,2022-07-14
2022-04-01,Southwest,315,123,192,121,2,12,3,9,3,0,Greater MN,2022-07-14
2022-04-01,State,7737,6475,1262,6304,171,1307,1028,279,996,32,State,2022-07-14
2022-04-01,West Central,151,87,64,86,1,10,5,5,5,0,Greater MN,2022-07-14
2021-04-02,Central,820,620,200,575,45,97,65,32,49,16,Greater MN,2022-07-14
2021-04-02,Metro,3823,3423,400,3189,234,834,683,151,606,77,Metro,2022-07-14
2021-04-02,Northeast,966,540,426,514,26,114,85,29,81,4,Greater MN,2022-07-14
2021-04-02,Northwest,328,140,188,137,3,29,13,16,8,5,Greater MN,2022-07-14
2021-04-02,South Central,378,213,165,204,9,24,8,16,8,0,Greater MN,2022-07-14
2021-04-02,Southeast,1288,987,301,969,18,252,154,98,145,9,Greater MN,2022-07-14
2021-04-02,Southwest,364,123,241,115,8,13,0,13,0,0,Greater MN,2022-07-14
2021-04-02,State,8175,6124,2051,5775,349,1383,1017,366,906,111,State,2022-07-14
2021-04-02,West Central,208,78,130,72,6,20,9,11,9,0,Greater MN,2022-07-14
2022-04-02,Central,649,554,95,545,9,111,92,19,89,3,Greater MN,2022-07-14
2022-04-02,Metro,3890,3665,225,3554,111,774,667,107,643,24,Metro,2022-07-14
2022-04-02,Northeast,772,450,322,439,11,105,69,36,66,3,Greater MN,2022-07-14
2022-04-02,Northwest,239,124,115,119,5,24,13,11,12,1,Greater MN,2022-07-14
2022-04-02,South Central,319,200,119,194,6,22,9,13,8,1,Greater MN,2022-07-14
2022-04-02,Southeast,1290,1016,274,994,22,261,169,92,167,2,Greater MN,2022-07-14
2022-04-02,Southwest,304,109,195,108,1,10,2,8,2,0,Greater MN,2022-07-14
2022-04-02,State,7610,6199,1411,6033,166,1316,1024,292,990,34,State,2022-07-14
2022-04-02,West Central,147,81,66,80,1,9,3,6,3,0,Greater MN,2022-07-14
2021-04-03,Central,822,584,238,539,45,97,66,31,50,16,Greater MN,2022-07-14
2021-04-03,Metro,3738,3300,438,3056,244,830,673,157,595,78,Metro,2022-07-14
2021-04-03,Northeast,951,482,469,462,20,114,82,32,72,10,Greater MN,2022-07-14
2021-04-03,Northwest,328,128,200,124,4,31,18,13,13,5,Greater MN,2022-07-14
2021-04-03,South Central,376,200,176,192,8,24,10,14,10,0,Greater MN,2022-07-14
2021-04-03,Southeast,1281,937,344,926,11,253,154,99,145,9,Greater MN,2022-07-14
2021-04-03,Southwest,369,105,264,98,7,14,0,14,0,0,Greater MN,2022-07-14
2021-04-03,State,8073,5825,2248,5479,346,1383,1011,372,893,118,State,2022-07-14
2021-04-03,West Central,208,89,119,82,7,20,8,12,8,0,Greater MN,2022-07-14
2022-04-03,Central,651,534,117,524,10,103,80,23,78,2,Greater MN,2022-07-14
2022-04-03,Metro,3758,3487,271,3382,105,755,628,127,604,24,Metro,2022-07-14
2022-04-03,Northeast,761,410,351,398,12,105,76,29,73,3,Greater MN,2022-07-14
2022-04-03,Northwest,234,110,124,105,5,25,18,7,17,1,Greater MN,2022-07-14
2022-04-03,South Central,319,200,119,194,6,22,8,14,7,1,Greater MN,2022-07-14
2022-04-03,Southeast,1295,951,344,929,22,257,162,95,159,3,Greater MN,2022-07-14
2022-04-03,Southwest,298,100,198,99,1,10,2,8,2,0,Greater MN,2022-07-14
2022-04-03,State,7457,5852,1605,5691,161,1286,978,308,944,34,State,2022-07-14
2022-04-03,West Central,141,60,81,60,0,9,4,5,4,0,Greater MN,2022-07-14
2021-04-04,Central,785,519,266,483,36,100,68,32,47,21,Greater MN,2022-07-14
2021-04-04,Metro,3585,3175,410,2933,242,826,662,164,588,74,Metro,2022-07-14
2021-04-04,Northeast,961,502,459,472,30,114,68,46,65,3,Greater MN,2022-07-14
2021-04-04,Northwest,345,135,210,131,4,29,13,16,8,5,Greater MN,2022-07-14
2021-04-04,South Central,370,196,174,188,8,26,8,18,7,1,Greater MN,2022-07-14
2021-04-04,Southeast,1262,819,443,808,11,252,143,109,135,8,Greater MN,2022-07-14
2021-04-04,Southwest,356,99,257,94,5,13,0,13,0,0,Greater MN,2022-07-14
2021-04-04,State,7872,5524,2348,5180,344,1380,965,415,853,112,State,2022-07-14
2021-04-04,West Central,208,79,129,71,8,20,3,17,3,0,Greater MN,2022-07-14
2022-04-04,Central,656,567,89,552,15,107,87,20,85,2,Greater MN,2022-07-14
2022-04-04,Metro,3744,3525,219,3416,109,766,627,139,604,23,Metro,2022-07-14
2022-04-04,Northeast,765,428,337,417,11,105,75,30,71,4,Greater MN,2022-07-14
2022-04-04,Northwest,231,117,114,113,4,27,17,10,16,1,Greater MN,2022-07-14
2022-04-04,South Central,316,209,107,204,5,22,12,10,12,0,Greater MN,2022-07-14
2022-04-04,Southeast,1281,959,322,936,23,255,154,101,150,4,Greater MN,2022-07-14
2022-04-04,Southwest,301,100,201,99,1,11,1,10,1,0,Greater MN,2022-07-14
2022-04-04,State,7439,5973,1466,5805,168,1301,975,326,941,34,State,2022-07-14
2022-04-04,West Central,145,68,77,68,0,8,2,6,2,0,Greater MN,2022-07-14
2021-04-05,Central,788,531,257,486,45,103,71,32,53,18,Greater MN,2022-07-14
2021-04-05,Metro,3609,3242,367,2975,267,820,651,169,572,79,Metro,2022-07-14
2021-04-05,Northeast,961,495,466,464,31,114,88,26,84,4,Greater MN,2022-07-14
2021-04-05,Northwest,328,130,198,125,5,29,11,18,8,3,Greater MN,2022-07-14
2021-04-05,South Central,372,204,168,194,10,24,7,17,6,1,Greater MN,2022-07-14
2021-04-05,Southeast,1259,806,453,790,16,248,131,117,123,8,Greater MN,2022-07-14
2021-04-05,Southwest,360,89,271,84,5,14,0,14,0,0,Greater MN,2022-07-14
2021-04-05,State,7885,5568,2317,5182,386,1372,965,407,851,114,State,2022-07-14
2021-04-05,West Central,208,71,137,64,7,20,6,14,5,1,Greater MN,2022-07-14
2022-04-05,Central,675,596,79,583,13,109,89,20,88,1,Greater MN,2022-07-14
2022-04-05,Metro,3922,3707,215,3591,116,782,655,127,634,21,Metro,2022-07-14
2022-04-05,Northeast,767,480,287,468,12,105,82,23,78,4,Greater MN,2022-07-14
2022-04-05,Northwest,236,135,101,131,4,25,17,8,14,3,Greater MN,2022-07-14
2022-04-05,South Central,322,213,109,209,4,22,9,13,9,0,Greater MN,2022-07-14
2022-04-05,Southeast,1290,1043,247,1022,21,256,162,94,162,0,Greater MN,2022-07-14
2022-04-05,Southwest,315,118,197,118,0,10,0,10,0,0,Greater MN,2022-07-14
2022-04-05,State,7673,6367,1306,6197,170,1319,1018,301,989,29,State,2022-07-14
2022-04-05,West Central,146,75,71,75,0,10,4,6,4,0,Greater MN,2022-07-14
2021-04-06,Central,868,633,235,586,47,99,73,26,53,20,Greater MN,2022-07-14
2021-04-06,Metro,3857,3580,277,3315,265,837,674,163,575,99,Metro,2022-07-14
2021-04-06,Northeast,963,526,437,496,30,114,88,26,83,5,Greater MN,2022-07-14
2021-04-06,Northwest,326,128,198,120,8,30,14,16,10,4,Greater MN,2022-07-14
2021-04-06,South Central,378,236,142,221,15,24,8,16,7,1,Greater MN,2022-07-14
2021-04-06,Southeast,1264,928,336,909,19,249,159,90,152,7,Greater MN,2022-07-14
2021-04-06,Southwest,360,102,258,93,9,13,3,10,3,0,Greater MN,2022-07-14
2021-04-06,State,8224,6235,1989,5835,400,1386,1026,360,888,138,State,2022-07-14
2021-04-06,West Central,208,102,106,95,7,20,7,13,5,2,Greater MN,2022-07-14
2022-04-06,Central,710,641,69,626,15,102,76,26,75,1,Greater MN,2022-07-14
2022-04-06,Metro,4212,4011,201,3902,109,781,657,124,633,24,Metro,2022-07-14
2022-04-06,Northeast,767,492,275,480,12,105,75,30,72,3,Greater MN,2022-07-14
2022-04-06,Northwest,259,154,105,150,4,24,18,6,14,4,Greater MN,2022-07-14
2022-04-06,South Central,321,211,110,205,6,22,8,14,7,1,Greater MN,2022-07-14
2022-04-06,Southeast,1302,1095,207,1079,16,258,175,83,174,1,Greater MN,2022-07-14
2022-04-06,Southwest,338,149,189,149,0,10,0,10,0,0,Greater MN,2022-07-14
2022-04-06,State,8094,6869,1225,6705,164,1312,1015,297,981,34,State,2022-07-14
2022-04-06,West Central,185,116,69,114,2,10,6,4,6,0,Greater MN,2022-07-14
2021-04-07,Central,899,706,193,652,54,100,73,27,51,22,Greater MN,2022-07-14
2021-04-07,Metro,4192,3901,291,3609,292,838,697,141,606,91,Metro,2022-07-14
2021-04-07,Northeast,964,546,418,518,28,114,90,24,86,4,Greater MN,2022-07-14
2021-04-07,Northwest,343,153,190,144,9,29,10,19,7,3,Greater MN,2022-07-14
2021-04-07,South Central,377,232,145,218,14,24,9,15,8,1,Greater MN,2022-07-14
2021-04-07,Southeast,1280,993,287,971,22,255,151,104,144,7,Greater MN,2022-07-14
2021-04-07,Southwest,391,142,249,132,10,12,3,9,1,2,Greater MN,2022-07-14
2021-04-07,State,8686,6817,1869,6379,438,1392,1036,356,905,131,State,2022-07-14
2021-04-07,West Central,240,144,96,135,9,20,3,17,2,1,Greater MN,2022-07-14
2022-04-07,Central,670,586,84,573,13,99,75,24,75,0,Greater MN,2022-07-14
2022-04-07,Metro,4015,3864,151,3753,111,789,651,138,630,21,Metro,2022-07-14
2022-04-07,Northeast,767,505,262,492,13,105,77,28,74,3,Greater MN,2022-07-14
2022-04-07,Northwest,246,149,97,145,4,23,15,8,13,2,Greater MN,2022-07-14
2022-04-07,South Central,320,220,100,215,5,22,10,12,9,1,Greater MN,2022-07-14
2022-04-07,Southeast,1292,1106,186,1084,22,256,182,74,178,4,Greater MN,2022-07-14
2022-04-07,Southwest,325,124,201,123,1,12,4,8,4,0,Greater MN,2022-07-14
2022-04-07,State,7783,6638,1145,6468,170,1317,1021,296,990,31,State,2022-07-14
2022-04-07,West Central,148,84,64,83,1,11,7,4,7,0,Greater MN,2022-07-14
2021-04-08,Central,843,633,210,576,57,100,73,27,52,21,Greater MN,2022-07-14
2021-04-08,Metro,3984,3752,232,3441,311,854,731,123,638,93,Metro,2022-07-14
2021-04-08,Northeast,959,533,426,502,31,114,89,25,84,5,Greater MN,2022-07-14
2021-04-08,Northwest,328,151,177,141,10,29,8,21,5,3,Greater MN,2022-07-14
2021-04-08,South Central,374,223,151,207,16,26,12,14,10,2,Greater MN,2022-07-14
2021-04-08,Southeast,1251,977,274,956,21,249,170,79,163,7,Greater MN,2022-07-14
2021-04-08,Southwest,371,133,238,120,13,13,3,10,1,2,Greater MN,2022-07-14
2021-04-08,State,8318,6504,1814,6038,466,1405,1089,316,955,134,State,2022-07-14
2021-04-08,West Central,208,102,106,95,7,20,3,17,2,1,Greater MN,2022-07-14
2022-04-08,Central,664,590,74,577,13,96,73,23,73,0,Greater MN,2022-07-14
2022-04-08,Metro,4022,3840,182,3737,103,787,650,137,626,24,Metro,2022-07-14
2022-04-08,Northeast,767,508,259,492,16,106,73,33,71,2,Greater MN,2022-07-14
2022-04-08,Northwest,243,152,91,148,4,25,15,10,13,2,Greater MN,2022-07-14
2022-04-08,South Central,322,212,110,208,4,22,10,12,9,1,Greater MN,2022-07-14
2022-04-08,Southeast,1282,1097,185,1073,24,253,178,75,174,4,Greater MN,2022-07-14
2022-04-08,Southwest,317,108,209,106,2,11,4,7,4,0,Greater MN,2022-07-14
2022-04-08,State,7766,6585,1181,6417,168,1310,1009,301,976,33,State,2022-07-14
2022-04-08,West Central,149,78,71,76,2,10,6,4,6,0,Greater MN,2022-07-14
2021-04-09,Central,840,620,220,573,47,99,71,28,51,20,Greater MN,2022-07-14
2021-04-09,Metro,4040,3854,186,3542,312,842,710,132,617,93,Metro,2022-07-14
2021-04-09,Northeast,958,550,408,516,34,114,75,39,68,7,Greater MN,2022-07-14
2021-04-09,Northwest,328,164,164,156,8,29,11,18,9,2,Greater MN,2022-07-14
2021-04-09,South Central,377,226,151,209,17,25,9,16,7,2,Greater MN,2022-07-14
2021-04-09,Southeast,1267,1045,222,1014,31,250,166,84,160,6,Greater MN,2022-07-14
2021-04-09,Southwest,365,120,245,108,12,17,7,10,4,3,Greater MN,2022-07-14
2021-04-09,State,8383,6672,1711,6204,468,1396,1053,343,919,134,State,2022-07-14
2021-04-09,West Central,208,93,115,86,7,20,4,16,3,1,Greater MN,2022-07-14
2022-04-09,Central,680,597,83,581,16,95,72,23,72,0,Greater MN,2022-07-14
2022-04-09,Metro,3947,3746,201,3646,100,779,638,141,616,22,Metro,2022-07-14
2022-04-09,Northeast,768,493,275,479,14,106,73,33,71,2,Greater MN,2022-07-14
2022-04-09,Northwest,239,126,113,122,4,27,16,11,14,2,Greater MN,2022-07-14
2022-04-09,South Central,319,191,128,188,3,22,9,13,8,1,Greater MN,2022-07-14
2022-04-09,Southeast,1288,1066,222,1044,22,257,175,82,171,4,Greater MN,2022-07-14
2022-04-09,Southwest,299,92,207,90,2,12,1,11,1,0,Greater MN,2022-07-14
2022-04-09,State,7691,6394,1297,6231,163,1308,991,317,960,31,State,2022-07-14
2022-04-09,West Central,151,83,68,81,2,10,7,3,7,0,Greater MN,2022-07-14
2021-04-10,Central,840,615,225,547,68,101,70,31,52,18,Greater MN,2022-07-14
2021-04-10,Metro,3963,3684,279,3375,309,843,713,130,615,98,Metro,2022-07-14
2021-04-10,Northeast,956,537,419,504,33,114,86,28,79,7,Greater MN,2022-07-14
2021-04-10,Northwest,327,143,184,136,7,29,15,14,9,6,Greater MN,2022-07-14
2021-04-10,South Central,380,210,170,194,16,24,10,14,7,3,Greater MN,2022-07-14
2021-04-10,Southeast,1264,995,269,972,23,256,164,92,157,7,Greater MN,2022-07-14
2021-04-10,Southwest,359,107,252,96,11,14,5,9,2,3,Greater MN,2022-07-14
2021-04-10,State,8297,6381,1916,5905,476,1401,1070,331,928,142,State,2022-07-14
2021-04-10,West Central,208,90,118,81,9,20,7,13,7,0,Greater MN,2022-07-14
2022-04-10,Central,645,542,103,529,13,100,74,26,74,0,Greater MN,2022-07-14
2022-04-10,Metro,3855,3663,192,3563,100,745,628,117,604,24,Metro,2022-07-14
2022-04-10,Northeast,762,459,303,447,12,107,68,39,66,2,Greater MN,2022-07-14
2022-04-10,Northwest,241,120,121,116,4,25,15,10,13,2,Greater MN,2022-07-14
2022-04-10,South Central,321,183,138,179,4,22,10,12,9,1,Greater MN,2022-07-14
2022-04-10,Southeast,1290,982,308,966,16,256,155,101,153,2,Greater MN,2022-07-14
2022-04-10,Southwest,299,90,209,89,1,13,3,10,3,0,Greater MN,2022-07-14
2022-04-10,State,7564,6111,1453,5959,152,1276,959,317,928,31,State,2022-07-14
2022-04-10,West Central,151,72,79,70,2,8,6,2,6,0,Greater MN,2022-07-14
2021-04-11,Central,825,609,216,543,66,97,67,30,47,20,Greater MN,2022-07-14
2021-04-11,Metro,3824,3486,338,3176,310,835,711,124,602,109,Metro,2022-07-14
2021-04-11,Northeast,953,514,439,475,39,114,79,35,71,8,Greater MN,2022-07-14
2021-04-11,Northwest,327,136,191,127,9,31,13,18,5,8,Greater MN,2022-07-14
2021-04-11,South Central,377,204,173,186,18,25,10,15,6,4,Greater MN,2022-07-14
2021-04-11,Southeast,1267,943,324,917,26,249,150,99,143,7,Greater MN,2022-07-14
2021-04-11,Southwest,354,109,245,92,17,15,5,10,2,3,Greater MN,2022-07-14
2021-04-11,State,8135,6091,2044,5600,491,1386,1042,344,881,161,State,2022-07-14
2021-04-11,West Central,208,90,118,84,6,20,7,13,5,2,Greater MN,2022-07-14
2022-04-11,Central,646,547,99,537,10,101,75,26,74,1,Greater MN,2022-07-14
2022-04-11,Metro,3856,3639,217,3529,110,741,623,118,600,23,Metro,2022-07-14
2022-04-11,Northeast,745,461,284,449,12,95,66,29,63,3,Greater MN,2022-07-14
2022-04-11,Northwest,241,131,110,127,4,25,17,8,15,2,Greater MN,2022-07-14
2022-04-11,South Central,316,195,121,190,5,22,8,14,6,2,Greater MN,2022-07-14
2022-04-11,Southeast,1277,973,304,959,14,252,143,109,141,2,Greater MN,2022-07-14
2022-04-11,Southwest,301,90,211,90,0,12,5,7,5,0,Greater MN,2022-07-14
2022-04-11,State,7533,6105,1428,5948,157,1257,941,316,908,33,State,2022-07-14
2022-04-11,West Central,151,69,82,67,2,9,4,5,4,0,Greater MN,2022-07-14
2021-04-12,Central,836,620,216,544,76,97,65,32,46,19,Greater MN,2022-07-14
2021-04-12,Metro,3749,3419,330,3097,322,833,698,135,587,111,Metro,2022-07-14
2021-04-12,Northeast,953,533,420,493,40,114,79,35,69,10,Greater MN,2022-07-14
2021-04-12,Northwest,328,147,181,133,14,31,15,16,8,7,Greater MN,2022-07-14
2021-04-12,South Central,380,206,174,192,14,24,11,13,7,4,Greater MN,2022-07-14
2021-04-12,Southeast,1266,938,328,909,29,256,142,114,137,5,Greater MN,2022-07-14
2021-04-12,Southwest,365,116,249,100,16,15,4,11,1,3,Greater MN,2022-07-14
2021-04-12,State,8085,6073,2012,5556,517,1390,1019,371,860,159,State,2022-07-14
2021-04-12,West Central,208,94,114,88,6,20,5,15,5,0,Greater MN,2022-07-14
2022-04-12,Central,685,613,72,604,9,101,77,24,76,1,Greater MN,2022-07-14
2022-04-12,Metro,4036,3895,141,3790,105,752,639,113,613,26,Metro,2022-07-14
2022-04-12,Northeast,752,534,218,521,13,106,80,26,77,3,Greater MN,2022-07-14
2022-04-12,Northwest,242,151,91,147,4,23,17,6,15,2,Greater MN,2022-07-14
2022-04-12,South Central,319,219,100,215,4,24,10,14,9,1,Greater MN,2022-07-14
2022-04-12,Southeast,1279,1016,263,1005,11,259,163,96,160,3,Greater MN,2022-07-14
2022-04-12,Southwest,299,104,195,104,0,11,2,9,2,0,Greater MN,2022-07-14
2022-04-12,State,7764,6627,1137,6479,148,1286,992,294,956,36,State,2022-07-14
2022-04-12,West Central,152,95,57,93,2,10,4,6,4,0,Greater MN,2022-07-14
2021-04-13,Central,859,664,195,595,69,95,63,32,40,23,Greater MN,2022-07-14
2021-04-13,Metro,3916,3654,262,3312,342,859,727,132,618,109,Metro,2022-07-14
2021-04-13,Northeast,952,540,412,505,35,114,83,31,72,11,Greater MN,2022-07-14
2021-04-13,Northwest,329,166,163,154,12,31,12,19,7,5,Greater MN,2022-07-14
2021-04-13,South Central,380,212,168,195,17,24,10,14,6,4,Greater MN,2022-07-14
2021-04-13,Southeast,1265,960,305,933,27,248,153,95,144,9,Greater MN,2022-07-14
2021-04-13,Southwest,373,133,240,123,10,13,3,10,0,3,Greater MN,2022-07-14
2021-04-13,State,8282,6434,1848,5917,517,1404,1057,347,893,164,State,2022-07-14
2021-04-13,West Central,208,105,103,100,5,20,6,14,6,0,Greater MN,2022-07-14
2022-04-13,Central,745,680,65,665,15,101,77,24,76,1,Greater MN,2022-07-14
2022-04-13,Metro,4300,4126,174,4014,112,763,645,118,620,25,Metro,2022-07-14
2022-04-13,Northeast,751,549,202,539,10,106,79,27,76,3,Greater MN,2022-07-14
2022-04-13,Northwest,261,169,92,165,4,25,14,11,12,2,Greater MN,2022-07-14
2022-04-13,South Central,330,221,109,216,5,22,10,12,10,0,Greater MN,2022-07-14
2022-04-13,Southeast,1301,1079,222,1066,13,258,172,86,169,3,Greater MN,2022-07-14
2022-04-13,Southwest,318,100,218,100,0,12,3,9,3,0,Greater MN,2022-07-14
2022-04-13,State,8188,7043,1145,6884,159,1299,1006,293,972,34,State,2022-07-14
2022-04-13,West Central,182,119,63,119,0,12,6,6,6,0,Greater MN,2022-07-14
2021-04-14,Central,889,692,197,616,76,99,67,32,48,19,Greater MN,2022-07-14
2021-04-14,Metro,4167,3879,288,3517,362,861,740,121,630,110,Metro,2022-07-14
2021-04-14,Northeast,957,561,396,530,31,114,86,28,72,14,Greater MN,2022-07-14
2021-04-14,Northwest,344,155,189,148,7,31,15,16,8,7,Greater MN,2022-07-14
2021-04-14,South Central,370,213,157,193,20,24,11,13,7,4,Greater MN,2022-07-14
2021-04-14,Southeast,1286,1000,286,977,23,244,154,90,143,11,Greater MN,2022-07-14
2021-04-14,Southwest,394,148,246,135,13,16,4,12,2,2,Greater MN,2022-07-14
2021-04-14,State,8647,6783,1864,6248,535,1409,1085,324,917,168,State,2022-07-14
2021-04-14,West Central,240,135,105,132,3,20,8,12,7,1,Greater MN,2022-07-14
2022-04-14,Central,695,623,72,611,12,99,74,25,74,0,Greater MN,2022-07-14
2022-04-14,Metro,4081,3920,161,3794,126,756,647,109,625,22,Metro,2022-07-14
2022-04-14,Northeast,770,561,209,549,12,106,78,28,74,4,Greater MN,2022-07-14
2022-04-14,Northwest,243,164,79,161,3,23,14,9,12,2,Greater MN,2022-07-14
2022-04-14,South Central,327,212,115,206,6,22,10,12,10,0,Greater MN,2022-07-14
2022-04-14,Southeast,1288,1047,241,1030,17,256,173,83,171,2,Greater MN,2022-07-14
2022-04-14,Southwest,305,98,207,98,0,15,8,7,8,0,Greater MN,2022-07-14
2022-04-14,State,7856,6708,1148,6532,176,1285,1006,279,976,30,State,2022-07-14
2022-04-14,West Central,147,83,64,83,0,8,2,6,2,0,Greater MN,2022-07-14
2021-04-15,Central,830,643,187,581,62,101,71,30,52,19,Greater MN,2022-07-14
2021-04-15,Metro,4022,3749,273,3403,346,857,729,128,616,113,Metro,2022-07-14
2021-04-15,Northeast,954,561,393,529,32,114,88,26,77,11,Greater MN,2022-07-14
2021-04-15,Northwest,328,156,172,149,7,31,15,16,9,6,Greater MN,2022-07-14
2021-04-15,South Central,379,194,185,174,20,24,10,14,7,3,Greater MN,2022-07-14
2021-04-15,Southeast,1269,990,279,963,27,254,167,87,157,10,Greater MN,2022-07-14
2021-04-15,Southwest,384,137,247,128,9,16,4,12,2,2,Greater MN,2022-07-14
2021-04-15,State,8374,6531,1843,6025,506,1417,1090,327,925,165,State,2022-07-14
2021-04-15,West Central,208,101,107,98,3,20,6,14,5,1,Greater MN,2022-07-14
2022-04-15,Central,686,613,73,602,11,94,69,25,68,1,Greater MN,2022-07-14
2022-04-15,Metro,4077,3920,157,3789,131,769,645,124,627,18,Metro,2022-07-14
2022-04-15,Northeast,770,531,239,521,10,102,74,28,70,4,Greater MN,2022-07-14
2022-04-15,Northwest,233,156,77,154,2,24,17,7,15,2,Greater MN,2022-07-14
2022-04-15,South Central,320,201,119,196,5,22,8,14,8,0,Greater MN,2022-07-14
2022-04-15,Southeast,1281,1074,207,1052,22,256,179,77,177,2,Greater MN,2022-07-14
2022-04-15,Southwest,315,110,205,110,0,12,4,8,4,0,Greater MN,2022-07-14
2022-04-15,State,7831,6680,1151,6499,181,1289,999,290,972,27,State,2022-07-14
2022-04-15,West Central,149,75,74,75,0,10,3,7,3,0,Greater MN,2022-07-14
2021-04-16,Central,825,647,178,591,56,104,72,32,44,28,Greater MN,2022-07-14
2021-04-16,Metro,4030,3768,262,3425,343,848,724,124,610,114,Metro,2022-07-14
2021-04-16,Northeast,954,565,389,532,33,116,98,18,87,11,Greater MN,2022-07-14
2021-04-16,Northwest,328,165,163,157,8,31,15,16,11,4,Greater MN,2022-07-14
2021-04-16,South Central,368,203,165,185,18,24,12,12,8,4,Greater MN,2022-07-14
2021-04-16,Southeast,1278,1031,247,998,33,255,169,86,159,10,Greater MN,2022-07-14
2021-04-16,Southwest,370,123,247,115,8,13,1,12,0,1,Greater MN,2022-07-14
2021-04-16,State,8361,6595,1766,6093,502,1411,1099,312,926,173,State,2022-07-14
2021-04-16,West Central,208,93,115,90,3,20,8,12,7,1,Greater MN,2022-07-14
2022-04-16,Central,646,569,77,556,13,95,69,26,69,0,Greater MN,2022-07-14
2022-04-16,Metro,3967,3712,255,3583,129,751,615,136,598,17,Metro,2022-07-14
2022-04-16,Northeast,762,505,257,492,13,112,73,39,69,4,Greater MN,2022-07-14
2022-04-16,Northwest,236,141,95,138,3,23,12,11,11,1,Greater MN,2022-07-14
2022-04-16,South Central,322,194,128,188,6,22,7,15,7,0,Greater MN,2022-07-14
2022-04-16,Southeast,1305,1064,241,1044,20,256,167,89,165,2,Greater MN,2022-07-14
2022-04-16,Southwest,314,113,201,113,0,12,4,8,4,0,Greater MN,2022-07-14
2022-04-16,State,7697,6365,1332,6180,185,1282,950,332,926,24,State,2022-07-14
2022-04-16,West Central,145,67,78,66,1,11,3,8,3,0,Greater MN,2022-07-14
2021-04-17,Central,813,617,196,546,71,104,76,28,50,26,Greater MN,2022-07-14
2021-04-17,Metro,3849,3570,279,3229,341,855,741,114,628,113,Metro,2022-07-14
2021-04-17,Northeast,961,514,447,479,35,114,97,17,85,12,Greater MN,2022-07-14
2021-04-17,Northwest,328,162,166,156,6,31,17,14,13,4,Greater MN,2022-07-14
2021-04-17,South Central,372,212,160,193,19,24,12,12,8,4,Greater MN,2022-07-14
2021-04-17,Southeast,1286,999,287,970,29,251,177,74,166,11,Greater MN,2022-07-14
2021-04-17,Southwest,367,126,241,117,9,12,1,11,0,1,Greater MN,2022-07-14
2021-04-17,State,8184,6294,1890,5777,517,1411,1126,285,955,171,State,2022-07-14
2021-04-17,West Central,208,94,114,87,7,20,5,15,5,0,Greater MN,2022-07-14
2022-04-17,Central,650,553,97,539,14,91,63,28,63,0,Greater MN,2022-07-14
2022-04-17,Metro,3872,3594,278,3465,129,745,617,128,601,16,Metro,2022-07-14
2022-04-17,Northeast,771,475,296,460,15,107,82,25,78,4,Greater MN,2022-07-14
2022-04-17,Northwest,238,133,105,131,2,23,12,11,11,1,Greater MN,2022-07-14
2022-04-17,South Central,323,191,132,182,9,22,11,11,11,0,Greater MN,2022-07-14
2022-04-17,Southeast,1298,985,313,967,18,255,152,103,149,3,Greater MN,2022-07-14
2022-04-17,Southwest,305,96,209,96,0,13,3,10,3,0,Greater MN,2022-07-14
2022-04-17,State,7602,6082,1520,5893,189,1266,943,323,919,24,State,2022-07-14
2022-04-17,West Central,145,55,90,53,2,10,3,7,3,0,Greater MN,2022-07-14
2021-04-18,Central,797,571,226,495,76,96,70,26,49,21,Greater MN,2022-07-14
2021-04-18,Metro,3805,3463,342,3132,331,845,726,119,610,116,Metro,2022-07-14
2021-04-18,Northeast,963,489,474,454,35,114,83,31,70,13,Greater MN,2022-07-14
2021-04-18,Northwest,328,154,174,147,7,31,15,16,11,4,Greater MN,2022-07-14
2021-04-18,South Central,369,212,157,194,18,24,10,14,7,3,Greater MN,2022-07-14
2021-04-18,Southeast,1283,919,364,890,29,251,157,94,144,13,Greater MN,2022-07-14
2021-04-18,Southwest,361,113,248,103,10,14,3,11,1,2,Greater MN,2022-07-14
2021-04-18,State,8114,6009,2105,5497,512,1395,1070,325,898,172,State,2022-07-14
2021-04-18,West Central,208,88,120,82,6,20,6,14,6,0,Greater MN,2022-07-14
2022-04-18,Central,663,580,83,564,16,93,65,28,64,1,Greater MN,2022-07-14
2022-04-18,Metro,3884,3603,281,3472,131,722,600,122,583,17,Metro,2022-07-14
2022-04-18,Northeast,771,452,319,434,18,107,89,18,85,4,Greater MN,2022-07-14
2022-04-18,Northwest,238,127,111,123,4,25,15,10,14,1,Greater MN,2022-07-14
2022-04-18,South Central,322,190,132,180,10,22,9,13,9,0,Greater MN,2022-07-14
2022-04-18,Southeast,1271,964,307,943,21,252,146,106,144,2,Greater MN,2022-07-14
2022-04-18,Southwest,307,100,207,99,1,14,4,10,4,0,Greater MN,2022-07-14
2022-04-18,State,7599,6076,1523,5873,203,1246,930,316,905,25,State,2022-07-14
2022-04-18,West Central,143,60,83,58,2,11,2,9,2,0,Greater MN,2022-07-14
2021-04-19,Central,841,608,233,534,74,93,65,28,40,25,Greater MN,2022-07-14
2021-04-19,Metro,3705,3395,310,3070,325,833,711,122,582,129,Metro,2022-07-14
2021-04-19,Northeast,960,498,462,462,36,114,85,29,71,14,Greater MN,2022-07-14
2021-04-19,Northwest,328,152,176,145,7,31,15,16,9,6,Greater MN,2022-07-14
2021-04-19,South Central,374,222,152,210,12,24,9,15,6,3,Greater MN,2022-07-14
2021-04-19,Southeast,1262,852,410,825,27,253,151,102,139,12,Greater MN,2022-07-14
2021-04-19,Southwest,361,117,244,107,10,14,5,9,1,4,Greater MN,2022-07-14
2021-04-19,State,8039,5929,2110,5436,493,1382,1047,335,854,193,State,2022-07-14
2021-04-19,West Central,208,85,123,83,2,20,6,14,6,0,Greater MN,2022-07-14
2022-04-19,Central,686,596,90,580,16,104,75,29,75,0,Greater MN,2022-07-14
2022-04-19,Metro,4024,3802,222,3683,119,754,643,111,626,17,Metro,2022-07-14
2022-04-19,Northeast,768,466,302,450,16,106,84,22,80,4,Greater MN,2022-07-14
2022-04-19,Northwest,255,150,105,148,2,25,10,15,8,2,Greater MN,2022-07-14
2022-04-19,South Central,320,179,141,170,9,22,9,13,9,0,Greater MN,2022-07-14
2022-04-19,Southeast,1281,1048,233,1027,21,257,153,104,151,2,Greater MN,2022-07-14
2022-04-19,Southwest,305,102,203,99,3,12,5,7,5,0,Greater MN,2022-07-14
2022-04-19,State,7789,6417,1372,6229,188,1291,983,308,958,25,State,2022-07-14
2022-04-19,West Central,150,74,76,72,2,11,4,7,4,0,Greater MN,2022-07-14
2021-04-20,Central,843,644,199,582,62,93,70,23,49,21,Greater MN,2022-07-14
2021-04-20,Metro,3890,3659,231,3330,329,860,739,121,603,136,Metro,2022-07-14
2021-04-20,Northeast,963,543,420,506,37,114,90,24,75,15,Greater MN,2022-07-14
2021-04-20,Northwest,328,141,187,136,5,31,19,12,13,6,Greater MN,2022-07-14
2021-04-20,South Central,379,226,153,209,17,25,9,16,6,3,Greater MN,2022-07-14
2021-04-20,Southeast,1275,955,320,932,23,254,181,73,173,8,Greater MN,2022-07-14
2021-04-20,Southwest,364,122,242,115,7,15,5,10,1,4,Greater MN,2022-07-14
2021-04-20,State,8250,6394,1856,5911,483,1412,1120,292,927,193,State,2022-07-14
2021-04-20,West Central,208,104,104,101,3,20,7,13,7,0,Greater MN,2022-07-14
2022-04-20,Central,701,653,48,635,18,109,85,24,85,0,Greater MN,2022-07-14
2022-04-20,Metro,4259,4050,209,3931,119,757,649,108,631,18,Metro,2022-07-14
2022-04-20,Northeast,767,496,271,482,14,106,80,26,76,4,Greater MN,2022-07-14
2022-04-20,Northwest,275,152,123,148,4,25,13,12,12,1,Greater MN,2022-07-14
2022-04-20,South Central,320,186,134,178,8,24,11,13,11,0,Greater MN,2022-07-14
2022-04-20,Southeast,1296,1099,197,1078,21,259,172,87,169,3,Greater MN,2022-07-14
2022-04-20,Southwest,326,109,217,105,4,12,2,10,2,0,Greater MN,2022-07-14
2022-04-20,State,8126,6852,1274,6662,190,1302,1013,289,987,26,State,2022-07-14
2022-04-20,West Central,182,107,75,105,2,10,1,9,1,0,Greater MN,2022-07-14
2021-04-21,Central,851,645,206,590,55,102,78,24,50,28,Greater MN,2022-07-14
2021-04-21,Metro,4096,3811,285,3472,339,851,742,109,616,126,Metro,2022-07-14
2021-04-21,Northeast,964,540,424,502,38,114,90,24,74,16,Greater MN,2022-07-14
2021-04-21,Northwest,342,182,160,177,5,31,18,13,14,4,Greater MN,2022-07-14
2021-04-21,South Central,382,238,144,218,20,24,9,15,5,4,Greater MN,2022-07-14
2021-04-21,Southeast,1279,964,315,942,22,254,185,69,170,15,Greater MN,2022-07-14
2021-04-21,Southwest,381,121,260,114,7,15,6,9,3,3,Greater MN,2022-07-14
2021-04-21,State,8535,6638,1897,6147,491,1411,1133,278,937,196,State,2022-07-14
2021-04-21,West Central,240,137,103,132,5,20,5,15,5,0,Greater MN,2022-07-14
2022-04-21,Central,658,602,56,582,20,105,82,23,82,0,Greater MN,2022-07-14
2022-04-21,Metro,4105,3957,148,3827,130,760,646,114,628,18,Metro,2022-07-14
2022-04-21,Northeast,768,506,262,489,17,106,86,20,82,4,Greater MN,2022-07-14
2022-04-21,Northwest,247,135,112,132,3,28,20,8,18,2,Greater MN,2022-07-14
2022-04-21,South Central,323,194,129,186,8,22,8,14,8,0,Greater MN,2022-07-14
2022-04-21,Southeast,1292,1099,193,1075,24,257,164,93,161,3,Greater MN,2022-07-14
2022-04-21,Southwest,318,113,205,110,3,12,1,11,1,0,Greater MN,2022-07-14
2022-04-21,State,7854,6667,1187,6460,207,1300,1012,288,985,27,State,2022-07-14
2022-04-21,West Central,143,61,82,59,2,10,5,5,5,0,Greater MN,2022-07-14
2021-04-22,Central,841,635,206,578,57,99,75,24,46,29,Greater MN,2022-07-14
2021-04-22,Metro,3960,3669,291,3351,318,857,729,128,596,133,Metro,2022-07-14
2021-04-22,Northeast,960,521,439,484,37,114,89,25,75,14,Greater MN,2022-07-14
2021-04-22,Northwest,326,185,141,177,8,31,18,13,12,6,Greater MN,2022-07-14
2021-04-22,South Central,381,236,145,213,23,24,10,14,7,3,Greater MN,2022-07-14
2021-04-22,Southeast,1267,1019,248,991,28,252,188,64,175,13,Greater MN,2022-07-14
2021-04-22,Southwest,364,123,241,114,9,14,6,8,3,3,Greater MN,2022-07-14
2021-04-22,State,8307,6487,1820,5999,488,1411,1122,289,920,202,State,2022-07-14
2021-04-22,West Central,208,99,109,91,8,20,7,13,6,1,Greater MN,2022-07-14
2022-04-22,Central,633,571,62,556,15,105,78,27,75,3,Greater MN,2022-07-14
2022-04-22,Metro,4063,3919,144,3792,127,762,650,112,631,19,Metro,2022-07-14
2022-04-22,Northeast,773,506,267,487,19,104,84,20,80,4,Greater MN,2022-07-14
2022-04-22,Northwest,249,143,106,139,4,28,21,7,18,3,Greater MN,2022-07-14
2022-04-22,South Central,319,192,127,184,8,22,10,12,10,0,Greater MN,2022-07-14
2022-04-22,Southeast,1299,1084,215,1055,29,258,167,91,165,2,Greater MN,2022-07-14
2022-04-22,Southwest,324,127,197,124,3,12,3,9,3,0,Greater MN,2022-07-14
2022-04-22,State,7810,6608,1202,6401,207,1300,1016,284,985,31,State,2022-07-14
2022-04-22,West Central,150,66,84,64,2,9,3,6,3,0,Greater MN,2022-07-14
2021-04-23,Central,840,651,189,597,54,98,68,30,41,27,Greater MN,2022-07-14
2021-04-23,Metro,3894,3620,274,3322,298,850,726,124,601,125,Metro,2022-07-14
2021-04-23,Northeast,960,519,441,483,36,114,82,32,68,14,Greater MN,2022-07-14
2021-04-23,Northwest,326,163,163,155,8,31,18,13,12,6,Greater MN,2022-07-14
2021-04-23,South Central,377,223,154,202,21,24,9,15,8,1,Greater MN,2022-07-14
2021-04-23,Southeast,1277,1036,241,1010,26,254,188,66,175,13,Greater MN,2022-07-14
2021-04-23,Southwest,368,116,252,106,10,14,5,9,2,3,Greater MN,2022-07-14
2021-04-23,State,8250,6417,1833,5957,460,1405,1103,302,913,190,State,2022-07-14
2021-04-23,West Central,208,89,119,82,7,20,7,13,6,1,Greater MN,2022-07-14
2022-04-23,Central,622,551,71,541,10,109,85,24,85,0,Greater MN,2022-07-14
2022-04-23,Metro,3996,3857,139,3731,126,774,642,132,622,20,Metro,2022-07-14
2022-04-23,Northeast,769,487,282,469,18,104,87,17,84,3,Greater MN,2022-07-14
2022-04-23,Northwest,243,128,115,125,3,28,22,6,18,4,Greater MN,2022-07-14
2022-04-23,South Central,323,197,126,191,6,22,8,14,8,0,Greater MN,2022-07-14
2022-04-23,Southeast,1291,1073,218,1038,35,260,165,95,161,4,Greater MN,2022-07-14
2022-04-23,Southwest,320,111,209,108,3,11,1,10,1,0,Greater MN,2022-07-14
2022-04-23,State,7719,6466,1253,6264,202,1317,1013,304,982,31,State,2022-07-14
2022-04-23,West Central,155,62,93,61,1,9,3,6,3,0,Greater MN,2022-07-14
2021-04-24,Central,823,608,215,552,56,96,65,31,38,27,Greater MN,2022-07-14
2021-04-24,Metro,3929,3603,326,3314,289,851,709,142,587,122,Metro,2022-07-14
2021-04-24,Northeast,958,485,473,457,28,114,85,29,70,15,Greater MN,2022-07-14
2021-04-24,Northwest,329,154,175,146,8,31,20,11,15,5,Greater MN,2022-07-14
2021-04-24,South Central,372,208,164,192,16,24,9,15,8,1,Greater MN,2022-07-14
2021-04-24,Southeast,1279,1030,249,1003,27,252,175,77,162,13,Greater MN,2022-07-14
2021-04-24,Southwest,365,134,231,124,10,15,4,11,0,4,Greater MN,2022-07-14
2021-04-24,State,8263,6307,1956,5866,441,1403,1072,331,884,188,State,2022-07-14
2021-04-24,West Central,208,85,123,78,7,20,5,15,4,1,Greater MN,2022-07-14
2022-04-24,Central,619,553,66,542,11,114,96,18,95,1,Greater MN,2022-07-14
2022-04-24,Metro,3939,3744,195,3603,141,754,635,119,619,16,Metro,2022-07-14
2022-04-24,Northeast,768,488,280,468,20,104,74,30,72,2,Greater MN,2022-07-14
2022-04-24,Northwest,246,124,122,121,3,27,22,5,19,3,Greater MN,2022-07-14
2022-04-24,South Central,327,193,134,187,6,22,10,12,10,0,Greater MN,2022-07-14
2022-04-24,Southeast,1288,1017,271,979,38,261,152,109,149,3,Greater MN,2022-07-14
2022-04-24,Southwest,315,100,215,98,2,11,1,10,1,0,Greater MN,2022-07-14
2022-04-24,State,7645,6278,1367,6055,223,1304,993,311,968,25,State,2022-07-14
2022-04-24,West Central,143,59,84,57,2,11,3,8,3,0,Greater MN,2022-07-14
2021-04-25,Central,793,569,224,514,55,93,64,29,39,25,Greater MN,2022-07-14
2021-04-25,Metro,3736,3405,331,3131,274,842,704,138,588,116,Metro,2022-07-14
2021-04-25,Northeast,967,450,517,419,31,114,88,26,73,15,Greater MN,2022-07-14
2021-04-25,Northwest,328,161,167,150,11,31,15,16,10,5,Greater MN,2022-07-14
2021-04-25,South Central,374,200,174,182,18,24,9,15,8,1,Greater MN,2022-07-14
2021-04-25,Southeast,1277,941,336,910,31,246,168,78,157,11,Greater MN,2022-07-14
2021-04-25,Southwest,364,143,221,129,14,15,1,14,0,1,Greater MN,2022-07-14
2021-04-25,State,8047,5943,2104,5503,440,1385,1055,330,877,178,State,2022-07-14
2021-04-25,West Central,208,74,134,68,6,20,6,14,2,4,Greater MN,2022-07-14
2022-04-25,Central,631,565,66,551,14,108,85,23,85,0,Greater MN,2022-07-14
2022-04-25,Metro,3879,3724,155,3583,141,752,621,131,606,15,Metro,2022-07-14
2022-04-25,Northeast,767,508,259,487,21,106,78,28,75,3,Greater MN,2022-07-14
2022-04-25,Northwest,245,131,114,126,5,29,24,5,22,2,Greater MN,2022-07-14
2022-04-25,South Central,329,201,128,192,9,23,10,13,10,0,Greater MN,2022-07-14
2022-04-25,Southeast,1284,981,303,942,39,257,155,102,153,2,Greater MN,2022-07-14
2022-04-25,Southwest,307,92,215,90,2,11,4,7,4,0,Greater MN,2022-07-14
2022-04-25,State,7583,6268,1315,6035,233,1297,981,316,959,22,State,2022-07-14
2022-04-25,West Central,141,66,75,64,2,11,4,7,4,0,Greater MN,2022-07-14
2021-04-26,Central,807,578,229,512,66,96,64,32,41,23,Greater MN,2022-07-14
2021-04-26,Metro,3727,3365,362,3082,283,845,698,147,575,123,Metro,2022-07-14
2021-04-26,Northeast,967,473,494,448,25,114,84,30,68,16,Greater MN,2022-07-14
2021-04-26,Northwest,328,166,162,151,15,31,16,15,11,5,Greater MN,2022-07-14
2021-04-26,South Central,378,201,177,185,16,24,8,16,7,1,Greater MN,2022-07-14
2021-04-26,Southeast,1261,910,351,877,33,245,156,89,143,13,Greater MN,2022-07-14
2021-04-26,Southwest,352,105,247,94,11,15,3,12,2,1,Greater MN,2022-07-14
2021-04-26,State,8028,5891,2137,5434,457,1390,1035,355,851,184,State,2022-07-14
2021-04-26,West Central,208,93,115,85,8,20,6,14,4,2,Greater MN,2022-07-14
2022-04-26,Central,665,608,57,595,13,111,87,24,87,0,Greater MN,2022-07-14
2022-04-26,Metro,4099,3971,128,3822,149,785,654,131,638,16,Metro,2022-07-14
2022-04-26,Northeast,748,500,248,479,21,106,83,23,79,4,Greater MN,2022-07-14
2022-04-26,Northwest,245,128,117,125,3,33,29,4,23,6,Greater MN,2022-07-14
2022-04-26,South Central,325,209,116,201,8,26,5,21,5,0,Greater MN,2022-07-14
2022-04-26,Southeast,1280,1003,277,974,29,253,183,70,180,3,Greater MN,2022-07-14
2022-04-26,Southwest,321,123,198,119,4,12,5,7,5,0,Greater MN,2022-07-14
2022-04-26,State,7833,6627,1206,6398,229,1337,1051,286,1022,29,State,2022-07-14
2022-04-26,West Central,150,85,65,83,2,11,5,6,5,0,Greater MN,2022-07-14
2021-04-27,Central,859,662,197,587,75,99,61,38,39,22,Greater MN,2022-07-14
2021-04-27,Metro,3960,3713,247,3429,284,863,718,145,597,121,Metro,2022-07-14
2021-04-27,Northeast,964,490,474,465,25,114,88,26,74,14,Greater MN,2022-07-14
2021-04-27,Northwest,328,180,148,167,13,31,18,13,13,5,Greater MN,2022-07-14
2021-04-27,South Central,382,216,166,191,25,22,9,13,9,0,Greater MN,2022-07-14
2021-04-27,Southeast,1259,960,299,937,23,248,162,86,149,13,Greater MN,2022-07-14
2021-04-27,Southwest,373,128,245,116,12,15,3,12,2,1,Greater MN,2022-07-14
2021-04-27,State,8334,6464,1870,5999,465,1412,1063,349,885,178,State,2022-07-14
2021-04-27,West Central,209,115,94,107,8,20,4,16,2,2,Greater MN,2022-07-14
2022-04-27,Central,701,644,57,633,11,119,96,23,95,1,Greater MN,2022-07-14
2022-04-27,Metro,4223,4079,144,3907,172,782,662,120,649,13,Metro,2022-07-14
2022-04-27,Northeast,762,525,237,497,28,106,77,29,75,2,Greater MN,2022-07-14
2022-04-27,Northwest,268,147,121,144,3,25,21,4,15,6,Greater MN,2022-07-14
2022-04-27,South Central,321,217,104,209,8,28,10,18,10,0,Greater MN,2022-07-14
2022-04-27,Southeast,1293,1086,207,1055,31,250,180,70,177,3,Greater MN,2022-07-14
2022-04-27,Southwest,324,126,198,123,3,10,2,8,2,0,Greater MN,2022-07-14
2022-04-27,State,8080,6949,1131,6690,259,1329,1052,277,1027,25,State,2022-07-14
2022-04-27,West Central,188,125,63,122,3,9,4,5,4,0,Greater MN,2022-07-14
2021-04-28,Central,889,690,199,615,75,97,69,28,45,24,Greater MN,2022-07-14
2021-04-28,Metro,4199,3912,287,3629,283,859,723,136,607,116,Metro,2022-07-14
2021-04-28,Northeast,964,502,462,478,24,114,90,24,78,12,Greater MN,2022-07-14
2021-04-28,Northwest,344,174,170,163,11,31,18,13,10,8,Greater MN,2022-07-14
2021-04-28,South Central,382,240,142,212,28,24,10,14,9,1,Greater MN,2022-07-14
2021-04-28,Southeast,1294,1007,287,980,27,250,165,85,153,12,Greater MN,2022-07-14
2021-04-28,Southwest,385,129,256,116,13,12,1,11,0,1,Greater MN,2022-07-14
2021-04-28,State,8697,6793,1904,6324,469,1407,1082,325,906,176,State,2022-07-14
2021-04-28,West Central,240,139,101,131,8,20,6,14,4,2,Greater MN,2022-07-14
2022-04-28,Central,668,588,80,580,8,112,93,19,91,2,Greater MN,2022-07-14
2022-04-28,Metro,4051,3935,116,3765,170,777,669,108,656,13,Metro,2022-07-14
2022-04-28,Northeast,769,522,247,496,26,104,80,24,78,2,Greater MN,2022-07-14
2022-04-28,Northwest,254,130,124,125,5,23,13,10,9,4,Greater MN,2022-07-14
2022-04-28,South Central,326,225,101,218,7,27,12,15,12,0,Greater MN,2022-07-14
2022-04-28,Southeast,1282,1049,233,1018,31,256,181,75,178,3,Greater MN,2022-07-14
2022-04-28,Southwest,311,125,186,123,2,10,1,9,1,0,Greater MN,2022-07-14
2022-04-28,State,7813,6660,1153,6408,252,1319,1053,266,1029,24,State,2022-07-14
2022-04-28,West Central,152,86,66,83,3,10,4,6,4,0,Greater MN,2022-07-14
2021-04-29,Central,853,652,201,583,69,91,62,29,43,19,Greater MN,2022-07-14
2021-04-29,Metro,3985,3730,255,3455,275,856,723,133,606,117,Metro,2022-07-14
2021-04-29,Northeast,962,524,438,498,26,114,89,25,77,12,Greater MN,2022-07-14
2021-04-29,Northwest,328,169,159,155,14,31,17,14,11,6,Greater MN,2022-07-14
2021-04-29,South Central,389,235,154,208,27,24,11,13,11,0,Greater MN,2022-07-14
2021-04-29,Southeast,1276,1001,275,977,24,251,161,90,151,10,Greater MN,2022-07-14
2021-04-29,Southwest,373,123,250,112,11,14,1,13,0,1,Greater MN,2022-07-14
2021-04-29,State,8374,6542,1832,6089,453,1401,1070,331,904,166,State,2022-07-14
2021-04-29,West Central,208,108,100,101,7,20,6,14,5,1,Greater MN,2022-07-14
2022-04-29,Central,662,596,66,580,16,116,94,22,93,1,Greater MN,2022-07-14
2022-04-29,Metro,3972,3854,118,3675,179,761,645,116,630,15,Metro,2022-07-14
2022-04-29,Northeast,770,526,244,504,22,106,82,24,79,3,Greater MN,2022-07-14
2022-04-29,Northwest,255,127,128,123,4,25,14,11,10,4,Greater MN,2022-07-14
2022-04-29,South Central,324,213,111,206,7,26,11,15,11,0,Greater MN,2022-07-14
2022-04-29,Southeast,1274,1031,243,997,34,257,173,84,169,4,Greater MN,2022-07-14
2022-04-29,Southwest,315,120,195,119,1,10,2,8,2,0,Greater MN,2022-07-14
2022-04-29,State,7725,6541,1184,6271,270,1311,1025,286,998,27,State,2022-07-14
2022-04-29,West Central,153,74,79,67,7,10,4,6,4,0,Greater MN,2022-07-14
2021-04-30,Central,810,599,211,539,60,102,73,29,52,21,Greater MN,2022-07-14
2021-04-30,Metro,3964,3800,164,3515,285,859,720,139,614,106,Metro,2022-07-14
2021-04-30,Northeast,957,496,461,464,32,114,85,29,75,10,Greater MN,2022-07-14
2021-04-30,Northwest,328,173,155,164,9,31,12,19,8,4,Greater MN,2022-07-14
2021-04-30,South Central,374,221,153,196,25,24,10,14,9,1,Greater MN,2022-07-14
2021-04-30,Southeast,1272,1023,249,1002,21,254,182,72,174,8,Greater MN,2022-07-14
2021-04-30,Southwest,370,123,247,108,15,15,3,12,2,1,Greater MN,2022-07-14
2021-04-30,State,8283,6532,1751,6078,454,1419,1092,327,940,152,State,2022-07-14
2021-04-30,West Central,208,97,111,90,7,20,7,13,6,1,Greater MN,2022-07-14
2022-04-30,Central,623,565,58,547,18,117,96,21,95,1,Greater MN,2022-07-14
2022-04-30,Metro,3896,3741,155,3559,182,741,626,115,611,15,Metro,2022-07-14
2022-04-30,Northeast,756,478,278,456,22,104,78,26,75,3,Greater MN,2022-07-14
2022-04-30,Northwest,248,127,121,125,2,25,18,7,14,4,Greater MN,2022-07-14
2022-04-30,South Central,326,201,125,192,9,22,10,12,10,0,Greater MN,2022-07-14
2022-04-30,Southeast,1287,1033,254,998,35,254,177,77,175,2,Greater MN,2022-07-14
2022-04-30,Southwest,310,106,204,105,1,11,3,8,3,0,Greater MN,2022-07-14
2022-04-30,State,7594,6333,1261,6058,275,1285,1011,274,986,25,State,2022-07-14
2022-04-30,West Central,148,82,66,76,6,11,3,8,3,0,Greater MN,2022-07-14
2021-05-01,Central,810,594,216,539,55,109,80,29,58,22,Greater MN,2022-07-14
2021-05-01,Metro,3953,3659,294,3382,277,862,725,137,616,109,Metro,2022-07-14
2021-05-01,Northeast,948,459,489,434,25,114,81,33,67,14,Greater MN,2022-07-14
2021-05-01,Northwest,328,174,154,163,11,31,14,17,10,4,Greater MN,2022-07-14
2021-05-01,South Central,382,211,171,191,20,24,10,14,7,3,Greater MN,2022-07-14
2021-05-01,Southeast,1279,985,294,960,25,254,173,81,168,5,Greater MN,2022-07-14
2021-05-01,Southwest,367,124,243,110,14,14,3,11,1,2,Greater MN,2022-07-14
2021-05-01,State,8275,6287,1988,5852,435,1428,1095,333,936,159,State,2022-07-14
2021-05-01,West Central,208,81,127,73,8,20,9,11,9,0,Greater MN,2022-07-14
2022-05-01,Central,613,539,74,523,16,102,82,20,80,2,Greater MN,2022-07-14
2022-05-01,Metro,3764,3515,249,3337,178,743,608,135,596,12,Metro,2022-07-14
2022-05-01,Northeast,754,459,295,440,19,104,66,38,61,5,Greater MN,2022-07-14
2022-05-01,Northwest,249,124,125,122,2,25,18,7,15,3,Greater MN,2022-07-14
2022-05-01,South Central,330,188,142,180,8,22,11,11,11,0,Greater MN,2022-07-14
2022-05-01,Southeast,1284,992,292,958,34,255,168,87,165,3,Greater MN,2022-07-14
2022-05-01,Southwest,312,109,203,108,1,11,3,8,3,0,Greater MN,2022-07-14
2022-05-01,State,7455,6001,1454,5737,264,1271,958,313,933,25,State,2022-07-14
2022-05-01,West Central,149,75,74,69,6,9,2,7,2,0,Greater MN,2022-07-14
2021-05-02,Central,811,601,210,552,49,112,76,36,55,21,Greater MN,2022-07-14
2021-05-02,Metro,3857,3547,310,3272,275,852,710,142,603,107,Metro,2022-07-14
2021-05-02,Northeast,955,480,475,450,30,114,82,32,69,13,Greater MN,2022-07-14
2021-05-02,Northwest,328,177,151,167,10,31,13,18,8,5,Greater MN,2022-07-14
2021-05-02,South Central,374,217,157,198,19,24,12,12,10,2,Greater MN,2022-07-14
2021-05-02,Southeast,1286,916,370,891,25,254,157,97,152,5,Greater MN,2022-07-14
2021-05-02,Southwest,361,127,234,116,11,14,2,12,0,2,Greater MN,2022-07-14
2021-05-02,State,8180,6148,2032,5725,423,1421,1058,363,903,155,State,2022-07-14
2021-05-02,West Central,208,83,125,79,4,20,6,14,6,0,Greater MN,2022-07-14
2022-05-02,Central,631,569,62,547,22,103,82,21,80,2,Greater MN,2022-07-14
2022-05-02,Metro,3852,3695,157,3508,187,753,616,137,602,14,Metro,2022-07-14
2022-05-02,Northeast,752,484,268,463,21,106,67,39,64,3,Greater MN,2022-07-14
2022-05-02,Northwest,255,127,128,125,2,25,16,9,12,4,Greater MN,2022-07-14
2022-05-02,South Central,331,177,154,170,7,22,8,14,8,0,Greater MN,2022-07-14
2022-05-02,Southeast,1277,972,305,938,34,251,157,94,155,2,Greater MN,2022-07-14
2022-05-02,Southwest,320,119,201,118,1,11,4,7,4,0,Greater MN,2022-07-14
2022-05-02,State,7567,6210,1357,5930,280,1281,955,326,930,25,State,2022-07-14
2022-05-02,West Central,149,67,82,61,6,10,5,5,5,0,Greater MN,2022-07-14
2021-05-03,Central,834,624,210,575,49,109,81,28,61,20,Greater MN,2022-07-14
2021-05-03,Metro,3769,3417,352,3140,277,851,698,153,595,103,Metro,2022-07-14
2021-05-03,Northeast,954,493,461,463,30,114,82,32,67,15,Greater MN,2022-07-14
2021-05-03,Northwest,328,170,158,159,11,31,12,19,9,3,Greater MN,2022-07-14
2021-05-03,South Central,373,214,159,190,24,24,10,14,9,1,Greater MN,2022-07-14
2021-05-03,Southeast,1278,908,370,884,24,255,154,101,148,6,Greater MN,2022-07-14
2021-05-03,Southwest,366,129,237,123,6,13,2,11,1,1,Greater MN,2022-07-14
2021-05-03,State,8110,6033,2077,5607,426,1417,1044,373,895,149,State,2022-07-14
2021-05-03,West Central,208,78,130,73,5,20,5,15,5,0,Greater MN,2022-07-14
2022-05-03,Central,663,612,51,592,20,108,87,21,85,2,Greater MN,2022-07-14
2022-05-03,Metro,3981,3873,108,3689,184,757,640,117,627,13,Metro,2022-07-14
2022-05-03,Northeast,759,493,266,480,13,103,70,33,67,3,Greater MN,2022-07-14
2022-05-03,Northwest,258,144,114,141,3,25,16,9,13,3,Greater MN,2022-07-14
2022-05-03,South Central,330,218,112,212,6,22,10,12,10,0,Greater MN,2022-07-14
2022-05-03,Southeast,1288,1030,258,998,32,254,181,73,178,3,Greater MN,2022-07-14
2022-05-03,Southwest,320,120,200,119,1,10,4,6,4,0,Greater MN,2022-07-14
2022-05-03,State,7754,6593,1161,6331,262,1290,1015,275,991,24,State,2022-07-14
2022-05-03,West Central,155,103,52,100,3,11,7,4,7,0,Greater MN,2022-07-14
2021-05-04,Central,862,672,190,620,52,109,85,24,62,23,Greater MN,2022-07-14
2021-05-04,Metro,3976,3723,253,3446,277,860,718,142,618,100,Metro,2022-07-14
2021-05-04,Northeast,957,548,409,518,30,114,85,29,72,13,Greater MN,2022-07-14
2021-05-04,Northwest,328,177,151,164,13,31,13,18,9,4,Greater MN,2022-07-14
2021-05-04,South Central,380,218,162,190,28,24,11,13,9,2,Greater MN,2022-07-14
2021-05-04,Southeast,1274,988,286,964,24,252,165,87,158,7,Greater MN,2022-07-14
2021-05-04,Southwest,375,131,244,127,4,15,3,12,3,0,Greater MN,2022-07-14
2021-05-04,State,8360,6547,1813,6115,432,1425,1086,339,937,149,State,2022-07-14
2021-05-04,West Central,208,90,118,86,4,20,6,14,6,0,Greater MN,2022-07-14
2022-05-04,Central,740,690,50,666,24,109,87,22,85,2,Greater MN,2022-07-14
2022-05-04,Metro,4208,4011,197,3828,183,765,640,125,623,17,Metro,2022-07-14
2022-05-04,Northeast,722,517,205,503,14,103,78,25,75,3,Greater MN,2022-07-14
2022-05-04,Northwest,271,163,108,159,4,26,20,6,17,3,Greater MN,2022-07-14
2022-05-04,South Central,334,223,111,216,7,22,12,10,12,0,Greater MN,2022-07-14
2022-05-04,Southeast,1304,1072,232,1039,33,253,188,65,184,4,Greater MN,2022-07-14
2022-05-04,Southwest,328,127,201,125,2,10,2,8,2,0,Greater MN,2022-07-14
2022-05-04,State,8097,6941,1156,6672,269,1296,1030,266,1001,29,State,2022-07-14
2022-05-04,West Central,190,138,52,136,2,8,3,5,3,0,Greater MN,2022-07-14
2021-05-05,Central,879,702,177,643,59,114,89,25,65,24,Greater MN,2022-07-14
2021-05-05,Metro,4229,3983,246,3721,262,855,719,136,615,104,Metro,2022-07-14
2021-05-05,Northeast,969,558,411,532,26,114,82,32,69,13,Greater MN,2022-07-14
2021-05-05,Northwest,344,194,150,178,16,31,15,16,12,3,Greater MN,2022-07-14
2021-05-05,South Central,384,225,159,205,20,24,10,14,7,3,Greater MN,2022-07-14
2021-05-05,Southeast,1293,1042,251,1020,22,251,171,80,166,5,Greater MN,2022-07-14
2021-05-05,Southwest,398,158,240,151,7,14,3,11,3,0,Greater MN,2022-07-14
2021-05-05,State,8736,6986,1750,6573,413,1423,1093,330,941,152,State,2022-07-14
2021-05-05,West Central,240,124,116,123,1,20,4,16,4,0,Greater MN,2022-07-14
2022-05-05,Central,701,629,72,605,24,104,81,23,80,1,Greater MN,2022-07-14
2022-05-05,Metro,4059,3871,188,3685,186,762,651,111,634,17,Metro,2022-07-14
2022-05-05,Northeast,763,516,247,497,19,104,73,31,70,3,Greater MN,2022-07-14
2022-05-05,Northwest,257,154,103,149,5,23,16,7,13,3,Greater MN,2022-07-14
2022-05-05,South Central,330,229,101,224,5,22,10,12,10,0,Greater MN,2022-07-14
2022-05-05,Southeast,1274,1071,203,1042,29,255,177,78,175,2,Greater MN,2022-07-14
2022-05-05,Southwest,317,121,196,120,1,11,2,9,2,0,Greater MN,2022-07-14
2022-05-05,State,7856,6682,1174,6411,271,1290,1015,275,989,26,State,2022-07-14
2022-05-05,West Central,155,91,64,89,2,9,5,4,5,0,Greater MN,2022-07-14
2021-05-06,Central,862,673,189,622,51,105,82,23,58,24,Greater MN,2022-07-14
2021-05-06,Metro,4035,3823,212,3559,264,860,717,143,619,98,Metro,2022-07-14
2021-05-06,Northeast,968,545,423,515,30,114,89,25,78,11,Greater MN,2022-07-14
2021-05-06,Northwest,328,177,151,158,19,31,14,17,12,2,Greater MN,2022-07-14
2021-05-06,South Central,384,224,160,200,24,24,10,14,8,2,Greater MN,2022-07-14
2021-05-06,Southeast,1284,1022,262,1002,20,250,165,85,158,7,Greater MN,2022-07-14
2021-05-06,Southwest,378,139,239,134,5,15,4,11,4,0,Greater MN,2022-07-14
2021-05-06,State,8447,6709,1738,6293,416,1419,1087,332,943,144,State,2022-07-14
2021-05-06,West Central,208,106,102,103,3,20,6,14,6,0,Greater MN,2022-07-14
2022-05-06,Central,677,605,72,584,21,108,87,21,85,2,Greater MN,2022-07-14
2022-05-06,Metro,4034,3906,128,3730,176,792,664,128,647,17,Metro,2022-07-14
2022-05-06,Northeast,766,520,246,503,17,104,77,27,74,3,Greater MN,2022-07-14
2022-05-06,Northwest,256,150,106,143,7,23,16,7,15,1,Greater MN,2022-07-14
2022-05-06,South Central,324,227,97,222,5,22,11,11,11,0,Greater MN,2022-07-14
2022-05-06,Southeast,1273,1079,194,1053,26,256,196,60,192,4,Greater MN,2022-07-14
2022-05-06,Southwest,324,125,199,120,5,10,2,8,2,0,Greater MN,2022-07-14
2022-05-06,State,7808,6690,1118,6432,258,1324,1057,267,1030,27,State,2022-07-14
2022-05-06,West Central,154,78,76,77,1,9,4,5,4,0,Greater MN,2022-07-14
2021-05-07,Central,843,649,194,603,46,115,87,28,65,22,Greater MN,2022-07-14
2021-05-07,Metro,3977,3733,244,3474,259,845,715,130,626,89,Metro,2022-07-14
2021-05-07,Northeast,960,527,433,502,25,114,88,26,79,9,Greater MN,2022-07-14
2021-05-07,Northwest,328,165,163,150,15,31,17,14,14,3,Greater MN,2022-07-14
2021-05-07,South Central,380,234,146,212,22,24,7,17,6,1,Greater MN,2022-07-14
2021-05-07,Southeast,1284,1025,259,1006,19,256,176,80,169,7,Greater MN,2022-07-14
2021-05-07,Southwest,379,135,244,130,5,14,2,12,2,0,Greater MN,2022-07-14
2021-05-07,State,8359,6575,1784,6180,395,1419,1100,319,967,133,State,2022-07-14
2021-05-07,West Central,208,107,101,103,4,20,8,12,6,2,Greater MN,2022-07-14
2022-05-07,Central,643,542,101,519,23,101,78,23,76,2,Greater MN,2022-07-14
2022-05-07,Metro,3910,3715,195,3523,192,776,657,119,635,22,Metro,2022-07-14
2022-05-07,Northeast,769,524,245,505,19,104,71,33,66,5,Greater MN,2022-07-14
2022-05-07,Northwest,252,133,119,130,3,23,14,9,12,2,Greater MN,2022-07-14
2022-05-07,South Central,316,219,97,214,5,22,10,12,10,0,Greater MN,2022-07-14
2022-05-07,Southeast,1285,1047,238,1013,34,256,190,66,187,3,Greater MN,2022-07-14
2022-05-07,Southwest,328,123,205,116,7,9,1,8,1,0,Greater MN,2022-07-14
2022-05-07,State,7649,6389,1260,6105,284,1300,1025,275,991,34,State,2022-07-14
2022-05-07,West Central,146,86,60,85,1,9,4,5,4,0,Greater MN,2022-07-14
2021-05-08,Central,836,614,222,574,40,113,83,30,59,24,Greater MN,2022-07-14
2021-05-08,Metro,3845,3556,289,3317,239,837,697,140,611,86,Metro,2022-07-14
2021-05-08,Northeast,953,508,445,478,30,114,84,30,73,11,Greater MN,2022-07-14
2021-05-08,Northwest,328,160,168,145,15,31,14,17,12,2,Greater MN,2022-07-14
2021-05-08,South Central,381,202,179,188,14,24,7,17,6,1,Greater MN,2022-07-14
2021-05-08,Southeast,1276,1031,245,1015,16,254,157,97,152,5,Greater MN,2022-07-14
2021-05-08,Southwest,371,130,241,125,5,14,3,11,3,0,Greater MN,2022-07-14
2021-05-08,State,8198,6303,1895,5940,363,1407,1052,355,922,130,State,2022-07-14
2021-05-08,West Central,208,102,106,98,4,20,7,13,6,1,Greater MN,2022-07-14
2022-05-08,Central,653,553,100,526,27,100,74,26,73,1,Greater MN,2022-07-14
2022-05-08,Metro,3843,3677,166,3477,200,761,645,116,622,23,Metro,2022-07-14
2022-05-08,Northeast,766,412,354,389,23,104,78,26,73,5,Greater MN,2022-07-14
2022-05-08,Northwest,251,126,125,121,5,24,13,11,11,2,Greater MN,2022-07-14
2022-05-08,South Central,315,203,112,196,7,22,10,12,10,0,Greater MN,2022-07-14
2022-05-08,Southeast,1288,1000,288,959,41,254,168,86,165,3,Greater MN,2022-07-14
2022-05-08,Southwest,318,105,213,102,3,9,2,7,2,0,Greater MN,2022-07-14
2022-05-08,State,7577,6165,1412,5857,308,1284,995,289,960,35,State,2022-07-14
2022-05-08,West Central,143,89,54,87,2,10,5,5,4,1,Greater MN,2022-07-14
2021-05-09,Central,800,570,230,533,37,107,77,30,58,19,Greater MN,2022-07-14
2021-05-09,Metro,3687,3315,372,3095,220,842,701,141,611,90,Metro,2022-07-14
2021-05-09,Northeast,953,507,446,473,34,114,78,36,66,12,Greater MN,2022-07-14
2021-05-09,Northwest,328,153,175,140,13,31,17,14,13,4,Greater MN,2022-07-14
2021-05-09,South Central,378,210,168,190,20,24,10,14,9,1,Greater MN,2022-07-14
2021-05-09,Southeast,1282,935,347,919,16,257,148,109,142,6,Greater MN,2022-07-14
2021-05-09,Southwest,365,122,243,116,6,14,3,11,3,0,Greater MN,2022-07-14
2021-05-09,State,8001,5903,2098,5552,351,1409,1041,368,908,133,State,2022-07-14
2021-05-09,West Central,208,91,117,86,5,20,7,13,6,1,Greater MN,2022-07-14
2022-05-09,Central,651,572,79,541,31,100,72,28,69,3,Greater MN,2022-07-14
2022-05-09,Metro,3821,3669,152,3458,211,769,634,135,615,19,Metro,2022-07-14
2022-05-09,Northeast,762,513,249,486,27,104,77,27,72,5,Greater MN,2022-07-14
2022-05-09,Northwest,256,137,119,130,7,25,18,7,15,3,Greater MN,2022-07-14
2022-05-09,South Central,317,200,117,191,9,22,7,15,7,0,Greater MN,2022-07-14
2022-05-09,Southeast,1288,996,292,956,40,257,181,76,175,6,Greater MN,2022-07-14
2022-05-09,Southwest,316,105,211,102,3,9,2,7,1,1,Greater MN,2022-07-14
2022-05-09,State,7558,6277,1281,5947,330,1298,998,300,960,38,State,2022-07-14
2022-05-09,West Central,147,85,62,83,2,12,7,5,6,1,Greater MN,2022-07-14
2021-05-10,Central,787,547,240,510,37,111,80,31,63,17,Greater MN,2022-07-14
2021-05-10,Metro,3710,3356,354,3133,223,830,681,149,587,94,Metro,2022-07-14
2021-05-10,Northeast,952,524,428,494,30,114,69,45,56,13,Greater MN,2022-07-14
2021-05-10,Northwest,328,163,165,153,10,31,15,16,12,3,Greater MN,2022-07-14
2021-05-10,South Central,379,212,167,191,21,24,9,15,8,1,Greater MN,2022-07-14
2021-05-10,Southeast,1283,923,360,905,18,253,154,99,148,6,Greater MN,2022-07-14
2021-05-10,Southwest,371,123,248,117,6,13,1,12,1,0,Greater MN,2022-07-14
2021-05-10,State,8018,5940,2078,5588,352,1396,1017,379,882,135,State,2022-07-14
2021-05-10,West Central,208,92,116,85,7,20,8,12,7,1,Greater MN,2022-07-14
2022-05-10,Central,684,611,73,576,35,101,75,26,71,4,Greater MN,2022-07-14
2022-05-10,Metro,4059,3922,137,3706,216,787,689,98,669,20,Metro,2022-07-14
2022-05-10,Northeast,760,534,226,499,35,104,80,24,75,5,Greater MN,2022-07-14
2022-05-10,Northwest,260,163,97,153,10,26,20,6,16,4,Greater MN,2022-07-14
2022-05-10,South Central,323,222,101,214,8,22,8,14,8,0,Greater MN,2022-07-14
2022-05-10,Southeast,1282,1073,209,1039,34,258,189,69,183,6,Greater MN,2022-07-14
2022-05-10,Southwest,303,111,192,110,1,9,2,7,1,1,Greater MN,2022-07-14
2022-05-10,State,7824,6727,1097,6381,346,1317,1070,247,1029,41,State,2022-07-14
2022-05-10,West Central,153,91,62,84,7,10,7,3,6,1,Greater MN,2022-07-14
2021-05-11,Central,831,622,209,587,35,104,74,30,60,14,Greater MN,2022-07-14
2021-05-11,Metro,3925,3629,296,3410,219,843,693,150,600,93,Metro,2022-07-14
2021-05-11,Northeast,957,522,435,489,33,114,90,24,77,13,Greater MN,2022-07-14
2021-05-11,Northwest,328,168,160,156,12,31,11,20,9,2,Greater MN,2022-07-14
2021-05-11,South Central,379,227,152,207,20,24,8,16,7,1,Greater MN,2022-07-14
2021-05-11,Southeast,1288,995,293,980,15,254,165,89,160,5,Greater MN,2022-07-14
2021-05-11,Southwest,372,147,225,139,8,13,0,13,0,0,Greater MN,2022-07-14
2021-05-11,State,8288,6419,1869,6073,346,1403,1050,353,921,129,State,2022-07-14
2021-05-11,West Central,208,109,99,105,4,20,9,11,8,1,Greater MN,2022-07-14
2022-05-11,Central,725,668,57,641,27,99,79,20,74,5,Greater MN,2022-07-14
2022-05-11,Metro,4291,4183,108,3950,233,781,678,103,659,19,Metro,2022-07-14
2022-05-11,Northeast,762,542,220,506,36,105,78,27,74,4,Greater MN,2022-07-14
2022-05-11,Northwest,272,177,95,169,8,27,21,6,19,2,Greater MN,2022-07-14
2022-05-11,South Central,321,217,104,212,5,22,7,15,7,0,Greater MN,2022-07-14
2022-05-11,Southeast,1305,1087,218,1049,38,258,180,78,176,4,Greater MN,2022-07-14
2022-05-11,Southwest,317,123,194,122,1,9,1,8,1,0,Greater MN,2022-07-14
2022-05-11,State,8180,7125,1055,6766,359,1312,1050,262,1016,34,State,2022-07-14
2022-05-11,West Central,187,128,59,117,11,11,6,5,6,0,Greater MN,2022-07-14
2021-05-12,Central,858,651,207,608,43,102,66,36,56,10,Greater MN,2022-07-14
2021-05-12,Metro,4112,3805,307,3598,207,839,701,138,608,93,Metro,2022-07-14
2021-05-12,Northeast,961,530,431,503,27,114,86,28,72,14,Greater MN,2022-07-14
2021-05-12,Northwest,344,183,161,173,10,31,15,16,14,1,Greater MN,2022-07-14
2021-05-12,South Central,378,217,161,200,17,24,9,15,7,2,Greater MN,2022-07-14
2021-05-12,Southeast,1307,1052,255,1040,12,255,173,82,165,8,Greater MN,2022-07-14
2021-05-12,Southwest,393,152,241,147,5,13,0,13,0,0,Greater MN,2022-07-14
2021-05-12,State,8593,6725,1868,6401,324,1398,1059,339,930,129,State,2022-07-14
2021-05-12,West Central,240,135,105,132,3,20,9,11,8,1,Greater MN,2022-07-14
2022-05-12,Central,699,634,65,607,27,95,74,21,70,4,Greater MN,2022-07-14
2022-05-12,Metro,4159,3988,171,3753,235,780,665,115,645,20,Metro,2022-07-14
2022-05-12,Northeast,755,527,228,491,36,106,84,22,80,4,Greater MN,2022-07-14
2022-05-12,Northwest,259,159,100,154,5,25,17,8,15,2,Greater MN,2022-07-14
2022-05-12,South Central,318,208,110,202,6,22,9,13,8,1,Greater MN,2022-07-14
2022-05-12,Southeast,1296,1064,232,1027,37,252,180,72,176,4,Greater MN,2022-07-14
2022-05-12,Southwest,312,130,182,129,1,10,2,8,1,1,Greater MN,2022-07-14
2022-05-12,State,7951,6801,1150,6443,358,1301,1039,262,1003,36,State,2022-07-14
2022-05-12,West Central,153,91,62,80,11,11,8,3,8,0,Greater MN,2022-07-14
2021-05-13,Central,839,641,198,592,49,112,71,41,59,12,Greater MN,2022-07-14
2021-05-13,Metro,3919,3637,282,3425,212,844,703,141,616,87,Metro,2022-07-14
2021-05-13,Northeast,955,547,408,515,32,114,81,33,68,13,Greater MN,2022-07-14
2021-05-13,Northwest,344,186,158,172,14,31,14,17,12,2,Greater MN,2022-07-14
2021-05-13,South Central,379,205,174,195,10,24,11,13,9,2,Greater MN,2022-07-14
2021-05-13,Southeast,1289,1027,262,1012,15,257,186,71,179,7,Greater MN,2022-07-14
2021-05-13,Southwest,380,149,231,142,7,14,1,13,1,0,Greater MN,2022-07-14
2021-05-13,State,8313,6487,1826,6146,341,1416,1073,343,950,123,State,2022-07-14
2021-05-13,West Central,208,95,113,93,2,20,6,14,6,0,Greater MN,2022-07-14
2022-05-13,Central,671,603,68,577,26,98,75,23,71,4,Greater MN,2022-07-14
2022-05-13,Metro,4073,3959,114,3713,246,773,669,104,648,21,Metro,2022-07-14
2022-05-13,Northeast,734,515,219,480,35,106,80,26,76,4,Greater MN,2022-07-14
2022-05-13,Northwest,253,153,100,145,8,28,22,6,19,3,Greater MN,2022-07-14
2022-05-13,South Central,309,223,86,217,6,22,10,12,8,2,Greater MN,2022-07-14
2022-05-13,Southeast,1286,1054,232,1026,28,253,178,75,170,8,Greater MN,2022-07-14
2022-05-13,Southwest,318,150,168,145,5,10,2,8,1,1,Greater MN,2022-07-14
2022-05-13,State,7790,6740,1050,6380,360,1301,1046,255,1002,44,State,2022-07-14
2022-05-13,West Central,146,83,63,77,6,11,10,1,9,1,Greater MN,2022-07-14
2021-05-14,Central,781,567,214,516,51,111,75,36,63,12,Greater MN,2022-07-14
2021-05-14,Metro,3884,3611,273,3382,229,831,689,142,603,86,Metro,2022-07-14
2021-05-14,Northeast,959,542,417,511,31,114,85,29,70,15,Greater MN,2022-07-14
2021-05-14,Northwest,328,183,145,171,12,31,11,20,9,2,Greater MN,2022-07-14
2021-05-14,South Central,378,210,168,200,10,24,8,16,6,2,Greater MN,2022-07-14
2021-05-14,Southeast,1269,1022,247,1012,10,254,179,75,170,9,Greater MN,2022-07-14
2021-05-14,Southwest,362,137,225,131,6,14,2,12,2,0,Greater MN,2022-07-14
2021-05-14,State,8169,6352,1817,5999,353,1399,1058,341,932,126,State,2022-07-14
2021-05-14,West Central,208,80,128,76,4,20,9,11,9,0,Greater MN,2022-07-14
2022-05-14,Central,657,556,101,529,27,89,66,23,64,2,Greater MN,2022-07-14
2022-05-14,Metro,3981,3756,225,3520,236,778,676,102,659,17,Metro,2022-07-14
2022-05-14,Northeast,738,472,266,439,33,106,85,21,79,6,Greater MN,2022-07-14
2022-05-14,Northwest,256,149,107,140,9,24,19,5,17,2,Greater MN,2022-07-14
2022-05-14,South Central,309,222,87,214,8,22,12,10,9,3,Greater MN,2022-07-14
2022-05-14,Southeast,1292,1034,258,1000,34,260,174,86,166,8,Greater MN,2022-07-14
2022-05-14,Southwest,313,124,189,120,4,10,3,7,2,1,Greater MN,2022-07-14
2022-05-14,State,7693,6393,1300,6037,356,1299,1043,256,1002,41,State,2022-07-14
2022-05-14,West Central,147,80,67,75,5,10,8,2,6,2,Greater MN,2022-07-14
2021-05-15,Central,803,584,219,536,48,106,71,35,60,11,Greater MN,2022-07-14
2021-05-15,Metro,3904,3586,318,3363,223,827,688,139,605,83,Metro,2022-07-14
2021-05-15,Northeast,954,519,435,486,33,114,75,39,63,12,Greater MN,2022-07-14
2021-05-15,Northwest,330,153,177,142,11,31,16,15,14,2,Greater MN,2022-07-14
2021-05-15,South Central,369,193,176,180,13,23,10,13,7,3,Greater MN,2022-07-14
2021-05-15,Southeast,1284,1021,263,1011,10,257,163,94,157,6,Greater MN,2022-07-14
2021-05-15,Southwest,373,150,223,147,3,14,2,12,2,0,Greater MN,2022-07-14
2021-05-15,State,8225,6287,1938,5943,344,1392,1031,361,914,117,State,2022-07-14
2021-05-15,West Central,208,81,127,78,3,20,6,14,6,0,Greater MN,2022-07-14
2022-05-15,Central,651,549,102,523,26,98,73,25,72,1,Greater MN,2022-07-14
2022-05-15,Metro,3848,3654,194,3408,246,764,663,101,644,19,Metro,2022-07-14
2022-05-15,Northeast,739,474,265,439,35,107,81,26,77,4,Greater MN,2022-07-14
2022-05-15,Northwest,257,143,114,134,9,22,14,8,12,2,Greater MN,2022-07-14
2022-05-15,South Central,309,227,82,215,12,22,8,14,8,0,Greater MN,2022-07-14
2022-05-15,Southeast,1288,999,289,961,38,255,160,95,152,8,Greater MN,2022-07-14
2022-05-15,Southwest,306,115,191,112,3,10,4,6,3,1,Greater MN,2022-07-14
2022-05-15,State,7546,6241,1305,5865,376,1288,1010,278,973,37,State,2022-07-14
2022-05-15,West Central,148,80,68,73,7,10,7,3,5,2,Greater MN,2022-07-14
2021-05-16,Central,807,572,235,527,45,101,68,33,58,10,Greater MN,2022-07-14
2021-05-16,Metro,3774,3405,369,3211,194,808,676,132,595,81,Metro,2022-07-14
2021-05-16,Northeast,953,516,437,489,27,114,77,37,68,9,Greater MN,2022-07-14
2021-05-16,Northwest,329,145,184,136,9,31,13,18,11,2,Greater MN,2022-07-14
2021-05-16,South Central,362,195,167,175,20,23,8,15,8,0,Greater MN,2022-07-14
2021-05-16,Southeast,1279,940,339,926,14,255,152,103,146,6,Greater MN,2022-07-14
2021-05-16,Southwest,373,139,234,136,3,14,1,13,1,0,Greater MN,2022-07-14
2021-05-16,State,8085,5998,2087,5682,316,1366,1000,366,892,108,State,2022-07-14
2021-05-16,West Central,208,86,122,82,4,20,5,15,5,0,Greater MN,2022-07-14
2022-05-16,Central,638,575,63,550,25,100,76,24,75,1,Greater MN,2022-07-14
2022-05-16,Metro,3900,3725,175,3463,262,770,661,109,641,20,Metro,2022-07-14
2022-05-16,Northeast,744,471,273,435,36,105,80,25,73,7,Greater MN,2022-07-14
2022-05-16,Northwest,257,161,96,153,8,22,16,6,14,2,Greater MN,2022-07-14
2022-05-16,South Central,314,213,101,202,11,22,9,13,9,0,Greater MN,2022-07-14
2022-05-16,Southeast,1278,968,310,924,44,255,147,108,139,8,Greater MN,2022-07-14
2022-05-16,Southwest,304,121,183,117,4,10,5,5,4,1,Greater MN,2022-07-14
2022-05-16,State,7585,6310,1275,5914,396,1295,1002,293,961,41,State,2022-07-14
2022-05-16,West Central,150,76,74,70,6,11,8,3,6,2,Greater MN,2022-07-14
2021-05-17,Central,830,600,230,553,47,95,65,30,55,10,Greater MN,2022-07-14
2021-05-17,Metro,3806,3481,325,3296,185,817,685,132,607,78,Metro,2022-07-14
2021-05-17,Northeast,959,527,432,492,35,114,91,23,80,11,Greater MN,2022-07-14
2021-05-17,Northwest,328,144,184,136,8,31,14,17,11,3,Greater MN,2022-07-14
2021-05-17,South Central,363,213,150,191,22,23,9,14,7,2,Greater MN,2022-07-14
2021-05-17,Southeast,1271,914,357,900,14,253,151,102,146,5,Greater MN,2022-07-14
2021-05-17,Southwest,379,130,249,123,7,15,5,10,5,0,Greater MN,2022-07-14
2021-05-17,State,8144,6090,2054,5767,323,1368,1029,339,919,110,State,2022-07-14
2021-05-17,West Central,208,81,127,76,5,20,9,11,8,1,Greater MN,2022-07-14
2022-05-17,Central,683,616,67,584,32,105,84,21,82,2,Greater MN,2022-07-14
2022-05-17,Metro,3995,3900,95,3641,259,784,681,103,664,17,Metro,2022-07-14
2022-05-17,Northeast,756,497,259,460,37,105,80,25,74,6,Greater MN,2022-07-14
2022-05-17,Northwest,256,167,89,159,8,27,21,6,20,1,Greater MN,2022-07-14
2022-05-17,South Central,320,229,91,219,10,22,10,12,10,0,Greater MN,2022-07-14
2022-05-17,Southeast,1270,999,271,956,43,256,168,88,159,9,Greater MN,2022-07-14
2022-05-17,Southwest,316,137,179,131,6,10,4,6,2,2,Greater MN,2022-07-14
2022-05-17,State,7750,6652,1098,6249,403,1319,1054,265,1017,37,State,2022-07-14
2022-05-17,West Central,154,107,47,99,8,10,6,4,6,0,Greater MN,2022-07-14
2021-05-18,Central,835,626,209,580,46,101,72,29,63,9,Greater MN,2022-07-14
2021-05-18,Metro,3880,3629,251,3444,185,844,716,128,635,81,Metro,2022-07-14
2021-05-18,Northeast,969,571,398,537,34,114,84,30,73,11,Greater MN,2022-07-14
2021-05-18,Northwest,328,166,162,157,9,31,16,15,12,4,Greater MN,2022-07-14
2021-05-18,South Central,376,245,131,230,15,24,6,18,4,2,Greater MN,2022-07-14
2021-05-18,Southeast,1266,981,285,966,15,259,168,91,164,4,Greater MN,2022-07-14
2021-05-18,Southwest,383,140,243,135,5,13,4,9,4,0,Greater MN,2022-07-14
2021-05-18,State,8245,6463,1782,6149,314,1406,1075,331,962,113,State,2022-07-14
2021-05-18,West Central,208,105,103,100,5,20,9,11,7,2,Greater MN,2022-07-14
2022-05-18,Central,718,636,82,605,31,116,91,25,86,5,Greater MN,2022-07-14
2022-05-18,Metro,4246,4111,135,3861,250,785,662,123,645,17,Metro,2022-07-14
2022-05-18,Northeast,757,528,229,494,34,105,85,20,79,6,Greater MN,2022-07-14
2022-05-18,Northwest,271,170,101,163,7,28,21,7,19,2,Greater MN,2022-07-14
2022-05-18,South Central,327,236,91,227,9,22,10,12,10,0,Greater MN,2022-07-14
2022-05-18,Southeast,1291,1068,223,1024,44,258,165,93,158,7,Greater MN,2022-07-14
2022-05-18,Southwest,327,138,189,132,6,9,2,7,1,1,Greater MN,2022-07-14
2022-05-18,State,8126,7021,1105,6633,388,1332,1040,292,1002,38,State,2022-07-14
2022-05-18,West Central,189,134,55,127,7,9,4,5,4,0,Greater MN,2022-07-14
2021-05-19,Central,830,657,173,612,45,103,75,28,64,11,Greater MN,2022-07-14
2021-05-19,Metro,4143,3862,281,3684,178,854,733,121,658,75,Metro,2022-07-14
2021-05-19,Northeast,967,558,409,525,33,114,88,26,79,9,Greater MN,2022-07-14
2021-05-19,Northwest,344,186,158,178,8,31,20,11,15,5,Greater MN,2022-07-14
2021-05-19,South Central,377,218,159,205,13,24,11,13,9,2,Greater MN,2022-07-14
2021-05-19,Southeast,1276,1041,235,1022,19,259,176,83,171,5,Greater MN,2022-07-14
2021-05-19,Southwest,394,137,257,133,4,14,4,10,3,1,Greater MN,2022-07-14
2021-05-19,State,8571,6787,1784,6484,303,1419,1115,304,1006,109,State,2022-07-14
2021-05-19,West Central,240,128,112,125,3,20,8,12,7,1,Greater MN,2022-07-14
2022-05-19,Central,653,571,82,534,37,106,83,23,82,1,Greater MN,2022-07-14
2022-05-19,Metro,4109,3979,130,3725,254,778,653,125,631,22,Metro,2022-07-14
2022-05-19,Northeast,749,508,241,470,38,105,77,28,70,7,Greater MN,2022-07-14
2022-05-19,Northwest,256,169,87,159,10,27,20,7,19,1,Greater MN,2022-07-14
2022-05-19,South Central,321,244,77,234,10,22,11,11,10,1,Greater MN,2022-07-14
2022-05-19,Southeast,1274,1072,202,1026,46,253,175,78,169,6,Greater MN,2022-07-14
2022-05-19,Southwest,318,130,188,127,3,10,3,7,2,1,Greater MN,2022-07-14
2022-05-19,State,7836,6784,1052,6381,403,1311,1026,285,987,39,State,2022-07-14
2022-05-19,West Central,156,111,45,106,5,10,4,6,4,0,Greater MN,2022-07-14
2021-05-20,Central,811,657,154,606,51,103,77,26,67,10,Greater MN,2022-07-14
2021-05-20,Metro,4015,3753,262,3591,162,862,728,134,644,84,Metro,2022-07-14
2021-05-20,Northeast,964,547,417,523,24,114,90,24,80,10,Greater MN,2022-07-14
2021-05-20,Northwest,328,150,178,140,10,31,9,22,6,3,Greater MN,2022-07-14
2021-05-20,South Central,374,229,145,216,13,24,11,13,9,2,Greater MN,2022-07-14
2021-05-20,Southeast,1263,987,276,973,14,258,179,79,174,5,Greater MN,2022-07-14
2021-05-20,Southwest,371,127,244,124,3,14,4,10,3,1,Greater MN,2022-07-14
2021-05-20,State,8334,6558,1776,6278,280,1426,1106,320,990,116,State,2022-07-14
2021-05-20,West Central,208,108,100,105,3,20,8,12,7,1,Greater MN,2022-07-14
2022-05-20,Central,661,580,81,548,32,105,83,22,80,3,Greater MN,2022-07-14
2022-05-20,Metro,4052,3922,130,3680,242,769,664,105,646,18,Metro,2022-07-14
2022-05-20,Northeast,745,497,248,459,38,107,81,26,76,5,Greater MN,2022-07-14
2022-05-20,Northwest,245,159,86,148,11,36,18,18,17,1,Greater MN,2022-07-14
2022-05-20,South Central,322,234,88,224,10,22,11,11,10,1,Greater MN,2022-07-14
2022-05-20,Southeast,1287,1095,192,1055,40,253,164,89,154,10,Greater MN,2022-07-14
2022-05-20,Southwest,319,134,185,129,5,9,2,7,1,1,Greater MN,2022-07-14
2022-05-20,State,7784,6728,1056,6345,383,1312,1030,282,990,40,State,2022-07-14
2022-05-20,West Central,153,107,46,102,5,11,7,4,6,1,Greater MN,2022-07-14
2021-05-21,Central,804,642,162,589,53,110,80,30,72,8,Greater MN,2022-07-14
2021-05-21,Metro,3990,3686,304,3541,145,855,708,147,624,84,Metro,2022-07-14
2021-05-21,Northeast,977,564,413,535,29,114,79,35,69,10,Greater MN,2022-07-14
2021-05-21,Northwest,329,162,167,150,12,31,10,21,9,1,Greater MN,2022-07-14
2021-05-21,South Central,375,226,149,214,12,24,10,14,9,1,Greater MN,2022-07-14
2021-05-21,Southeast,1263,1023,240,1005,18,257,176,81,173,3,Greater MN,2022-07-14
2021-05-21,Southwest,368,115,253,112,3,14,3,11,2,1,Greater MN,2022-07-14
2021-05-21,State,8314,6523,1791,6248,275,1425,1073,352,964,109,State,2022-07-14
2021-05-21,West Central,208,105,103,102,3,20,7,13,6,1,Greater MN,2022-07-14
2022-05-21,Central,654,583,71,550,33,95,74,21,73,1,Greater MN,2022-07-14
2022-05-21,Metro,3897,3742,155,3497,245,778,656,122,637,19,Metro,2022-07-14
2022-05-21,Northeast,737,503,234,461,42,105,85,20,80,5,Greater MN,2022-07-14
2022-05-21,Northwest,229,103,126,103,0,42,21,21,16,5,Greater MN,2022-07-14
2022-05-21,South Central,309,210,99,199,11,22,8,14,7,1,Greater MN,2022-07-14
2022-05-21,Southeast,1283,1032,251,987,45,251,163,88,154,9,Greater MN,2022-07-14
2022-05-21,Southwest,311,108,203,106,2,9,2,7,0,2,Greater MN,2022-07-14
2022-05-21,State,7575,6381,1194,5999,382,1313,1015,298,972,43,State,2022-07-14
2022-05-21,West Central,155,100,55,96,4,11,6,5,5,1,Greater MN,2022-07-14
2021-05-22,Central,783,608,175,556,52,116,82,34,74,8,Greater MN,2022-07-14
2021-05-22,Metro,3905,3625,280,3494,131,849,716,133,635,81,Metro,2022-07-14
2021-05-22,Northeast,971,500,471,473,27,114,81,33,69,12,Greater MN,2022-07-14
2021-05-22,Northwest,328,146,182,135,11,31,11,20,8,3,Greater MN,2022-07-14
2021-05-22,South Central,366,233,133,217,16,24,11,13,9,2,Greater MN,2022-07-14
2021-05-22,Southeast,1279,1008,271,990,18,260,167,93,163,4,Greater MN,2022-07-14
2021-05-22,Southwest,363,111,252,108,3,14,3,11,3,0,Greater MN,2022-07-14
2021-05-22,State,8203,6314,1889,6052,262,1428,1076,352,965,111,State,2022-07-14
2021-05-22,West Central,208,83,125,79,4,20,5,15,4,1,Greater MN,2022-07-14
2022-05-22,Central,640,569,71,536,33,94,66,28,63,3,Greater MN,2022-07-14
2022-05-22,Metro,3762,3591,171,3353,238,753,616,137,596,20,Metro,2022-07-14
2022-05-22,Northeast,756,494,262,453,41,105,79,26,75,4,Greater MN,2022-07-14
2022-05-22,Northwest,235,135,100,128,7,42,22,20,20,2,Greater MN,2022-07-14
2022-05-22,South Central,307,209,98,198,11,22,10,12,9,1,Greater MN,2022-07-14
2022-05-22,Southeast,1282,947,335,901,46,251,143,108,136,7,Greater MN,2022-07-14
2022-05-22,Southwest,311,117,194,113,4,9,1,8,0,1,Greater MN,2022-07-14
2022-05-22,State,7447,6153,1294,5766,387,1283,938,345,900,38,State,2022-07-14
2022-05-22,West Central,154,91,63,84,7,7,1,6,1,0,Greater MN,2022-07-14
2021-05-23,Central,795,610,185,558,52,103,72,31,65,7,Greater MN,2022-07-14
2021-05-23,Metro,3717,3416,301,3271,145,809,669,140,598,71,Metro,2022-07-14
2021-05-23,Northeast,972,507,465,478,29,114,82,32,71,11,Greater MN,2022-07-14
2021-05-23,Northwest,328,146,182,134,12,31,12,19,9,3,Greater MN,2022-07-14
2021-05-23,South Central,367,220,147,204,16,24,11,13,8,3,Greater MN,2022-07-14
2021-05-23,Southeast,1284,909,375,890,19,260,162,98,158,4,Greater MN,2022-07-14
2021-05-23,Southwest,367,106,261,104,2,12,0,12,0,0,Greater MN,2022-07-14
2021-05-23,State,8038,6006,2032,5727,279,1373,1011,362,911,100,State,2022-07-14
2021-05-23,West Central,208,92,116,88,4,20,3,17,2,1,Greater MN,2022-07-14
2022-05-23,Central,636,556,80,525,31,93,65,28,64,1,Greater MN,2022-07-14
2022-05-23,Metro,3781,3615,166,3378,237,759,638,121,617,21,Metro,2022-07-14
2022-05-23,Northeast,746,502,244,462,40,107,74,33,71,3,Greater MN,2022-07-14
2022-05-23,Northwest,243,126,117,119,7,36,14,22,13,1,Greater MN,2022-07-14
2022-05-23,South Central,310,202,108,190,12,22,9,13,8,1,Greater MN,2022-07-14
2022-05-23,Southeast,1282,945,337,898,47,249,134,115,129,5,Greater MN,2022-07-14
2022-05-23,Southwest,318,119,199,115,4,9,1,8,0,1,Greater MN,2022-07-14
2022-05-23,State,7466,6155,1311,5771,384,1282,936,346,903,33,State,2022-07-14
2022-05-23,West Central,150,90,60,84,6,7,1,6,1,0,Greater MN,2022-07-14
2021-05-24,Central,787,616,171,568,48,110,69,41,61,8,Greater MN,2022-07-14
2021-05-24,Metro,3757,3429,328,3276,153,803,656,147,590,66,Metro,2022-07-14
2021-05-24,Northeast,972,499,473,474,25,114,85,29,73,12,Greater MN,2022-07-14
2021-05-24,Northwest,328,140,188,127,13,31,10,21,7,3,Greater MN,2022-07-14
2021-05-24,South Central,370,226,144,212,14,24,9,15,6,3,Greater MN,2022-07-14
2021-05-24,Southeast,1271,893,378,875,18,260,151,109,148,3,Greater MN,2022-07-14
2021-05-24,Southwest,366,104,262,102,2,12,1,11,1,0,Greater MN,2022-07-14
2021-05-24,State,8059,5999,2060,5724,275,1374,985,389,889,96,State,2022-07-14
2021-05-24,West Central,208,92,116,90,2,20,4,16,3,1,Greater MN,2022-07-14
2022-05-24,Central,650,565,85,538,27,96,69,27,69,0,Greater MN,2022-07-14
2022-05-24,Metro,3963,3812,151,3587,225,764,648,116,626,22,Metro,2022-07-14
2022-05-24,Northeast,756,497,259,456,41,102,73,29,69,4,Greater MN,2022-07-14
2022-05-24,Northwest,254,137,117,129,8,25,14,11,12,2,Greater MN,2022-07-14
2022-05-24,South Central,318,226,92,216,10,22,10,12,9,1,Greater MN,2022-07-14
2022-05-24,Southeast,1287,992,295,950,42,253,159,94,156,3,Greater MN,2022-07-14
2022-05-24,Southwest,324,127,197,122,5,10,3,7,2,1,Greater MN,2022-07-14
2022-05-24,State,7699,6457,1242,6095,362,1279,977,302,944,33,State,2022-07-14
2022-05-24,West Central,147,101,46,97,4,7,1,6,1,0,Greater MN,2022-07-14
2021-05-25,Central,807,668,139,626,42,114,79,35,70,9,Greater MN,2022-07-14
2021-05-25,Metro,3905,3623,282,3458,165,817,664,153,601,63,Metro,2022-07-14
2021-05-25,Northeast,978,526,452,496,30,114,89,25,79,10,Greater MN,2022-07-14
2021-05-25,Northwest,328,162,166,150,12,31,17,14,16,1,Greater MN,2022-07-14
2021-05-25,South Central,377,228,149,219,9,24,7,17,4,3,Greater MN,2022-07-14
2021-05-25,Southeast,1248,960,288,951,9,256,167,89,164,3,Greater MN,2022-07-14
2021-05-25,Southwest,375,121,254,117,4,14,0,14,0,0,Greater MN,2022-07-14
2021-05-25,State,8226,6396,1830,6122,274,1390,1028,362,938,90,State,2022-07-14
2021-05-25,West Central,208,108,100,105,3,20,5,15,4,1,Greater MN,2022-07-14
2022-05-25,Central,683,619,64,592,27,95,70,25,69,1,Greater MN,2022-07-14
2022-05-25,Metro,4223,4085,138,3856,229,766,652,114,629,23,Metro,2022-07-14
2022-05-25,Northeast,753,524,229,483,41,104,72,32,67,5,Greater MN,2022-07-14
2022-05-25,Northwest,275,167,108,160,7,25,16,9,14,2,Greater MN,2022-07-14
2022-05-25,South Central,319,230,89,219,11,20,10,10,9,1,Greater MN,2022-07-14
2022-05-25,Southeast,1310,1096,214,1059,37,253,162,91,157,5,Greater MN,2022-07-14
2022-05-25,Southwest,331,134,197,131,3,11,4,7,4,0,Greater MN,2022-07-14
2022-05-25,State,8095,7006,1089,6648,358,1283,987,296,950,37,State,2022-07-14
2022-05-25,West Central,201,151,50,148,3,9,1,8,1,0,Greater MN,2022-07-14
2021-05-26,Central,835,690,145,651,39,127,93,34,84,9,Greater MN,2022-07-14
2021-05-26,Metro,4110,3862,248,3713,149,840,695,145,642,53,Metro,2022-07-14
2021-05-26,Northeast,973,568,405,540,28,114,90,24,80,10,Greater MN,2022-07-14
2021-05-26,Northwest,344,193,151,181,12,31,14,17,11,3,Greater MN,2022-07-14
2021-05-26,South Central,380,241,139,229,12,24,10,14,8,2,Greater MN,2022-07-14
2021-05-26,Southeast,1275,998,277,987,11,255,171,84,169,2,Greater MN,2022-07-14
2021-05-26,Southwest,400,142,258,140,2,15,1,14,1,0,Greater MN,2022-07-14
2021-05-26,State,8557,6833,1724,6579,254,1426,1079,347,999,80,State,2022-07-14
2021-05-26,West Central,240,139,101,138,1,20,5,15,4,1,Greater MN,2022-07-14
2022-05-26,Central,671,604,67,565,39,91,68,23,66,2,Greater MN,2022-07-14
2022-05-26,Metro,4086,3930,156,3693,237,780,665,115,636,29,Metro,2022-07-14
2022-05-26,Northeast,749,517,232,475,42,105,70,35,65,5,Greater MN,2022-07-14
2022-05-26,Northwest,256,151,105,145,6,24,13,11,11,2,Greater MN,2022-07-14
2022-05-26,South Central,316,220,96,212,8,20,10,10,9,1,Greater MN,2022-07-14
2022-05-26,Southeast,1294,1077,217,1038,39,250,170,80,168,2,Greater MN,2022-07-14
2022-05-26,Southwest,313,144,169,139,5,10,0,10,0,0,Greater MN,2022-07-14
2022-05-26,State,7845,6751,1094,6375,376,1289,998,291,957,41,State,2022-07-14
2022-05-26,West Central,160,108,52,108,0,9,2,7,2,0,Greater MN,2022-07-14
2021-05-27,Central,787,643,144,598,45,111,82,29,75,7,Greater MN,2022-07-14
2021-05-27,Metro,3957,3719,238,3583,136,825,684,141,638,46,Metro,2022-07-14
2021-05-27,Northeast,964,553,411,529,24,114,84,30,73,11,Greater MN,2022-07-14
2021-05-27,Northwest,334,180,154,169,11,31,14,17,10,4,Greater MN,2022-07-14
2021-05-27,South Central,377,237,140,229,8,25,11,14,8,3,Greater MN,2022-07-14
2021-05-27,Southeast,1258,1051,207,1039,12,254,173,81,169,4,Greater MN,2022-07-14
2021-05-27,Southwest,376,128,248,126,2,13,3,10,3,0,Greater MN,2022-07-14
2021-05-27,State,8261,6614,1647,6375,239,1393,1057,336,980,77,State,2022-07-14
2021-05-27,West Central,208,103,105,102,1,20,6,14,4,2,Greater MN,2022-07-14
2022-05-27,Central,704,629,75,591,38,104,75,29,72,3,Greater MN,2022-07-14
2022-05-27,Metro,4036,3898,138,3657,241,754,636,118,609,27,Metro,2022-07-14
2022-05-27,Northeast,755,522,233,481,41,108,76,32,71,5,Greater MN,2022-07-14
2022-05-27,Northwest,261,146,115,138,8,21,15,6,13,2,Greater MN,2022-07-14
2022-05-27,South Central,316,218,98,207,11,21,10,11,9,1,Greater MN,2022-07-14
2022-05-27,Southeast,1288,1098,190,1060,38,252,188,64,184,4,Greater MN,2022-07-14
2022-05-27,Southwest,310,125,185,123,2,10,1,9,1,0,Greater MN,2022-07-14
2022-05-27,State,7827,6729,1098,6350,379,1281,1007,274,965,42,State,2022-07-14
2022-05-27,West Central,157,93,64,93,0,11,6,5,6,0,Greater MN,2022-07-14
2021-05-28,Central,780,598,182,559,39,116,84,32,79,5,Greater MN,2022-07-14
2021-05-28,Metro,3929,3685,244,3568,117,819,673,146,618,55,Metro,2022-07-14
2021-05-28,Northeast,968,537,431,516,21,114,84,30,75,9,Greater MN,2022-07-14
2021-05-28,Northwest,334,159,175,153,6,31,12,19,7,5,Greater MN,2022-07-14
2021-05-28,South Central,371,220,151,209,11,24,10,14,7,3,Greater MN,2022-07-14
2021-05-28,Southeast,1276,1041,235,1028,13,259,172,87,168,4,Greater MN,2022-07-14
2021-05-28,Southwest,367,121,246,117,4,14,4,10,4,0,Greater MN,2022-07-14
2021-05-28,State,8233,6442,1791,6227,215,1397,1044,353,962,82,State,2022-07-14
2021-05-28,West Central,208,81,127,77,4,20,5,15,4,1,Greater MN,2022-07-14
2022-05-28,Central,701,642,59,597,45,99,78,21,76,2,Greater MN,2022-07-14
2022-05-28,Metro,3846,3688,158,3446,242,740,630,110,605,25,Metro,2022-07-14
2022-05-28,Northeast,756,484,272,443,41,107,70,37,64,6,Greater MN,2022-07-14
2022-05-28,Northwest,256,139,117,129,10,22,13,9,12,1,Greater MN,2022-07-14
2022-05-28,South Central,301,197,104,184,13,21,9,12,8,1,Greater MN,2022-07-14
2022-05-28,Southeast,1284,1100,184,1071,29,255,194,61,189,5,Greater MN,2022-07-14
2022-05-28,Southwest,310,120,190,118,2,10,2,8,2,0,Greater MN,2022-07-14
2022-05-28,State,7599,6450,1149,6067,383,1263,998,265,958,40,State,2022-07-14
2022-05-28,West Central,145,80,65,79,1,9,2,7,2,0,Greater MN,2022-07-14
2021-05-29,Central,746,548,198,520,28,120,85,35,80,5,Greater MN,2022-07-14
2021-05-29,Metro,3816,3539,277,3428,111,805,680,125,629,51,Metro,2022-07-14
2021-05-29,Northeast,965,468,497,449,19,114,82,32,71,11,Greater MN,2022-07-14
2021-05-29,Northwest,334,143,191,139,4,31,19,12,14,5,Greater MN,2022-07-14
2021-05-29,South Central,360,214,146,202,12,24,8,16,7,1,Greater MN,2022-07-14
2021-05-29,Southeast,1265,984,281,974,10,256,179,77,175,4,Greater MN,2022-07-14
2021-05-29,Southwest,365,94,271,89,5,15,2,13,2,0,Greater MN,2022-07-14
2021-05-29,State,8059,6065,1994,5873,192,1385,1061,324,983,78,State,2022-07-14
2021-05-29,West Central,208,75,133,72,3,20,6,14,5,1,Greater MN,2022-07-14
2022-05-29,Central,634,554,80,506,48,102,81,21,78,3,Greater MN,2022-07-14
2022-05-29,Metro,3772,3635,137,3381,254,754,620,134,596,24,Metro,2022-07-14
2022-05-29,Northeast,759,501,258,458,43,107,73,34,66,7,Greater MN,2022-07-14
2022-05-29,Northwest,253,150,103,140,10,21,8,13,7,1,Greater MN,2022-07-14
2022-05-29,South Central,298,191,107,175,16,20,9,11,8,1,Greater MN,2022-07-14
2022-05-29,Southeast,1289,1008,281,980,28,256,177,79,171,6,Greater MN,2022-07-14
2022-05-29,Southwest,315,113,202,111,2,13,2,11,1,1,Greater MN,2022-07-14
2022-05-29,State,7465,6228,1237,5825,403,1282,975,307,932,43,State,2022-07-14
2022-05-29,West Central,145,76,69,74,2,9,5,4,5,0,Greater MN,2022-07-14
2021-05-30,Central,785,569,216,543,26,110,74,36,68,6,Greater MN,2022-07-14
2021-05-30,Metro,3663,3355,308,3255,100,787,639,148,587,52,Metro,2022-07-14
2021-05-30,Northeast,961,454,507,434,20,114,79,35,68,11,Greater MN,2022-07-14
2021-05-30,Northwest,334,141,193,136,5,31,16,15,12,4,Greater MN,2022-07-14
2021-05-30,South Central,362,198,164,188,10,24,10,14,9,1,Greater MN,2022-07-14
2021-05-30,Southeast,1261,886,375,879,7,258,157,101,153,4,Greater MN,2022-07-14
2021-05-30,Southwest,365,106,259,101,5,14,3,11,3,0,Greater MN,2022-07-14
2021-05-30,State,7939,5781,2158,5606,175,1358,984,374,905,79,State,2022-07-14
2021-05-30,West Central,208,72,136,70,2,20,6,14,5,1,Greater MN,2022-07-14
2022-05-30,Central,636,538,98,493,45,101,80,21,77,3,Greater MN,2022-07-14
2022-05-30,Metro,3884,3695,189,3429,266,744,620,124,597,23,Metro,2022-07-14
2022-05-30,Northeast,757,493,264,451,42,107,71,36,64,7,Greater MN,2022-07-14
2022-05-30,Northwest,257,143,114,133,10,24,13,11,11,2,Greater MN,2022-07-14
2022-05-30,South Central,302,191,111,175,16,22,9,13,9,0,Greater MN,2022-07-14
2022-05-30,Southeast,1287,970,317,936,34,256,170,86,166,4,Greater MN,2022-07-14
2022-05-30,Southwest,310,101,209,100,1,13,5,8,3,2,Greater MN,2022-07-14
2022-05-30,State,7578,6209,1369,5789,420,1276,972,304,931,41,State,2022-07-14
2022-05-30,West Central,145,78,67,72,6,9,4,5,4,0,Greater MN,2022-07-14
2021-05-31,Central,777,571,206,544,27,112,72,40,67,5,Greater MN,2022-07-14
2021-05-31,Metro,3645,3283,362,3186,97,800,648,152,594,54,Metro,2022-07-14
2021-05-31,Northeast,961,481,480,461,20,114,83,31,69,14,Greater MN,2022-07-14
2021-05-31,Northwest,334,157,177,150,7,31,12,19,8,4,Greater MN,2022-07-14
2021-05-31,South Central,366,202,164,195,7,24,11,13,9,2,Greater MN,2022-07-14
2021-05-31,Southeast,1264,856,408,849,7,258,136,122,132,4,Greater MN,2022-07-14
2021-05-31,Southwest,360,109,251,104,5,14,1,13,1,0,Greater MN,2022-07-14
2021-05-31,State,7915,5726,2189,5553,173,1373,971,402,887,84,State,2022-07-14
2021-05-31,West Central,208,67,141,64,3,20,8,12,7,1,Greater MN,2022-07-14
2022-05-31,Central,645,559,86,511,48,103,77,26,75,2,Greater MN,2022-07-14
2022-05-31,Metro,3870,3687,183,3403,284,755,637,118,613,24,Metro,2022-07-14
2022-05-31,Northeast,754,511,243,469,42,107,65,42,59,6,Greater MN,2022-07-14
2022-05-31,Northwest,251,157,94,147,10,26,13,13,12,1,Greater MN,2022-07-14
2022-05-31,South Central,308,196,112,180,16,22,9,13,9,0,Greater MN,2022-07-14
2022-05-31,Southeast,1279,965,314,927,38,254,164,90,161,3,Greater MN,2022-07-14
2022-05-31,Southwest,311,94,217,92,2,13,5,8,3,2,Greater MN,2022-07-14
2022-05-31,State,7564,6253,1311,5809,444,1289,974,315,936,38,State,2022-07-14
2022-05-31,West Central,146,84,62,80,4,9,4,5,4,0,Greater MN,2022-07-14
2021-06-01,Central,786,609,177,580,29,112,69,43,63,6,Greater MN,2022-07-14
2021-06-01,Metro,3654,3297,357,3199,98,819,647,172,596,51,Metro,2022-07-14
2021-06-01,Northeast,963,527,436,507,20,114,85,29,71,14,Greater MN,2022-07-14
2021-06-01,Northwest,335,159,176,149,10,31,12,19,11,1,Greater MN,2022-07-14
2021-06-01,South Central,368,210,158,203,7,24,8,16,8,0,Greater MN,2022-07-14
2021-06-01,Southeast,1254,877,377,866,11,258,139,119,136,3,Greater MN,2022-07-14
2021-06-01,Southwest,365,99,266,93,6,13,0,13,0,0,Greater MN,2022-07-14
2021-06-01,State,7933,5844,2089,5660,184,1391,968,423,892,76,State,2022-07-14
2021-06-01,West Central,208,66,142,63,3,20,8,12,7,1,Greater MN,2022-07-14
2022-06-01,Central,709,641,68,608,33,110,85,25,83,2,Greater MN,2022-07-14
2022-06-01,Metro,4242,4091,151,3801,290,763,663,100,634,29,Metro,2022-07-14
2022-06-01,Northeast,755,549,206,508,41,107,64,43,60,4,Greater MN,2022-07-14
2022-06-01,Northwest,271,168,103,160,8,27,17,10,17,0,Greater MN,2022-07-14
2022-06-01,South Central,314,209,105,196,13,22,11,11,11,0,Greater MN,2022-07-14
2022-06-01,Southeast,1316,1073,243,1033,40,257,181,76,175,6,Greater MN,2022-07-14
2022-06-01,Southwest,319,110,209,110,0,13,5,8,3,2,Greater MN,2022-07-14
2022-06-01,State,8116,6970,1146,6538,432,1308,1030,278,987,43,State,2022-07-14
2022-06-01,West Central,190,129,61,122,7,9,4,5,4,0,Greater MN,2022-07-14
2021-06-02,Central,849,684,165,655,29,116,78,38,73,5,Greater MN,2022-07-14
2021-06-02,Metro,4096,3765,331,3670,95,839,709,130,662,47,Metro,2022-07-14
2021-06-02,Northeast,963,527,436,502,25,114,95,19,80,15,Greater MN,2022-07-14
2021-06-02,Northwest,351,180,171,172,8,31,15,16,13,2,Greater MN,2022-07-14
2021-06-02,South Central,374,214,160,209,5,25,10,15,10,0,Greater MN,2022-07-14
2021-06-02,Southeast,1272,961,311,951,10,258,152,106,150,2,Greater MN,2022-07-14
2021-06-02,Southwest,382,121,261,116,5,13,1,12,1,0,Greater MN,2022-07-14
2021-06-02,State,8527,6570,1957,6390,180,1416,1066,350,994,72,State,2022-07-14
2021-06-02,West Central,240,118,122,115,3,20,6,14,5,1,Greater MN,2022-07-14
2022-06-02,Central,682,625,57,592,33,106,83,23,81,2,Greater MN,2022-07-14
2022-06-02,Metro,4087,3948,139,3682,266,762,648,114,618,30,Metro,2022-07-14
2022-06-02,Northeast,755,563,192,522,41,107,67,40,59,8,Greater MN,2022-07-14
2022-06-02,Northwest,256,156,100,149,7,26,19,7,19,0,Greater MN,2022-07-14
2022-06-02,South Central,313,208,105,195,13,22,10,12,10,0,Greater MN,2022-07-14
2022-06-02,Southeast,1287,1079,208,1045,34,257,181,76,176,5,Greater MN,2022-07-14
2022-06-02,Southwest,312,124,188,124,0,11,2,9,1,1,Greater MN,2022-07-14
2022-06-02,State,7840,6803,1037,6403,400,1301,1017,284,970,47,State,2022-07-14
2022-06-02,West Central,148,100,48,94,6,10,7,3,6,1,Greater MN,2022-07-14
2021-06-03,Central,808,652,156,622,30,116,79,37,75,4,Greater MN,2022-07-14
2021-06-03,Metro,3957,3730,227,3627,103,840,717,123,674,43,Metro,2022-07-14
2021-06-03,Northeast,965,530,435,505,25,114,88,26,74,14,Greater MN,2022-07-14
2021-06-03,Northwest,334,198,136,190,8,31,13,18,12,1,Greater MN,2022-07-14
2021-06-03,South Central,383,228,155,223,5,24,8,16,8,0,Greater MN,2022-07-14
2021-06-03,Southeast,1267,1011,256,1001,10,256,164,92,161,3,Greater MN,2022-07-14
2021-06-03,Southwest,366,135,231,130,5,12,0,12,0,0,Greater MN,2022-07-14
2021-06-03,State,8288,6571,1717,6383,188,1413,1076,337,1010,66,State,2022-07-14
2021-06-03,West Central,208,87,121,85,2,20,7,13,6,1,Greater MN,2022-07-14
2022-06-03,Central,675,606,69,567,39,95,73,22,70,3,Greater MN,2022-07-14
2022-06-03,Metro,4028,3938,90,3696,242,770,655,115,624,31,Metro,2022-07-14
2022-06-03,Northeast,758,535,223,499,36,105,74,31,67,7,Greater MN,2022-07-14
2022-06-03,Northwest,257,161,96,153,8,25,17,8,16,1,Greater MN,2022-07-14
2022-06-03,South Central,312,194,118,181,13,22,9,13,8,1,Greater MN,2022-07-14
2022-06-03,Southeast,1278,1073,205,1041,32,256,185,71,179,6,Greater MN,2022-07-14
2022-06-03,Southwest,306,121,185,120,1,12,4,8,4,0,Greater MN,2022-07-14
2022-06-03,State,7766,6724,1042,6347,377,1294,1021,273,971,50,State,2022-07-14
2022-06-03,West Central,152,96,56,90,6,9,4,5,3,1,Greater MN,2022-07-14
2021-06-04,Central,806,637,169,607,30,116,82,34,77,5,Greater MN,2022-07-14
2021-06-04,Metro,3966,3729,237,3629,100,845,725,120,684,41,Metro,2022-07-14
2021-06-04,Northeast,965,530,435,505,25,114,88,26,77,11,Greater MN,2022-07-14
2021-06-04,Northwest,334,174,160,168,6,31,12,19,10,2,Greater MN,2022-07-14
2021-06-04,South Central,374,232,142,226,6,24,9,15,9,0,Greater MN,2022-07-14
2021-06-04,Southeast,1259,1009,250,1002,7,258,166,92,163,3,Greater MN,2022-07-14
2021-06-04,Southwest,373,117,256,111,6,14,1,13,1,0,Greater MN,2022-07-14
2021-06-04,State,8285,6527,1758,6345,182,1422,1091,331,1028,63,State,2022-07-14
2021-06-04,West Central,208,99,109,97,2,20,8,12,7,1,Greater MN,2022-07-14
2022-06-04,Central,652,593,59,553,40,88,65,23,63,2,Greater MN,2022-07-14
2022-06-04,Metro,3945,3798,147,3559,239,769,666,103,640,26,Metro,2022-07-14
2022-06-04,Northeast,739,513,226,479,34,104,69,35,65,4,Greater MN,2022-07-14
2022-06-04,Northwest,255,147,108,139,8,25,15,10,12,3,Greater MN,2022-07-14
2022-06-04,South Central,304,191,113,175,16,22,10,12,10,0,Greater MN,2022-07-14
2022-06-04,Southeast,1282,1047,235,1010,37,253,182,71,177,5,Greater MN,2022-07-14
2022-06-04,Southwest,300,109,191,108,1,11,1,10,1,0,Greater MN,2022-07-14
2022-06-04,State,7624,6486,1138,6106,380,1282,1012,270,971,41,State,2022-07-14
2022-06-04,West Central,147,88,59,83,5,10,4,6,3,1,Greater MN,2022-07-14
2021-06-05,Central,785,602,183,575,27,119,86,33,81,5,Greater MN,2022-07-14
2021-06-05,Metro,3930,3706,224,3612,94,822,687,135,648,39,Metro,2022-07-14
2021-06-05,Northeast,964,502,462,479,23,114,87,27,78,9,Greater MN,2022-07-14
2021-06-05,Northwest,334,152,182,148,4,31,17,14,14,3,Greater MN,2022-07-14
2021-06-05,South Central,363,214,149,208,6,22,7,15,7,0,Greater MN,2022-07-14
2021-06-05,Southeast,1251,956,295,951,5,255,162,93,159,3,Greater MN,2022-07-14
2021-06-05,Southwest,367,107,260,104,3,14,1,13,1,0,Greater MN,2022-07-14
2021-06-05,State,8202,6339,1863,6176,163,1397,1054,343,995,59,State,2022-07-14
2021-06-05,West Central,208,100,108,99,1,20,7,13,7,0,Greater MN,2022-07-14
2022-06-05,Central,657,571,86,537,34,90,61,29,58,3,Greater MN,2022-07-14
2022-06-05,Metro,3872,3670,202,3447,223,778,656,122,632,24,Metro,2022-07-14
2022-06-05,Northeast,753,521,232,483,38,111,69,42,65,4,Greater MN,2022-07-14
2022-06-05,Northwest,253,155,98,145,10,25,14,11,11,3,Greater MN,2022-07-14
2022-06-05,South Central,307,182,125,171,11,22,7,15,7,0,Greater MN,2022-07-14
2022-06-05,Southeast,1279,991,288,948,43,252,160,92,156,4,Greater MN,2022-07-14
2022-06-05,Southwest,304,101,203,100,1,11,0,11,0,0,Greater MN,2022-07-14
2022-06-05,State,7570,6275,1295,5909,366,1298,969,329,931,38,State,2022-07-14
2022-06-05,West Central,145,84,61,78,6,9,2,7,2,0,Greater MN,2022-07-14
2021-06-06,Central,781,579,202,552,27,107,72,35,68,4,Greater MN,2022-07-14
2021-06-06,Metro,3785,3499,286,3414,85,814,684,130,647,37,Metro,2022-07-14
2021-06-06,Northeast,966,489,477,469,20,114,84,30,72,12,Greater MN,2022-07-14
2021-06-06,Northwest,334,157,177,151,6,31,14,17,11,3,Greater MN,2022-07-14
2021-06-06,South Central,366,208,158,200,8,21,6,15,6,0,Greater MN,2022-07-14
2021-06-06,Southeast,1258,894,364,888,6,254,150,104,147,3,Greater MN,2022-07-14
2021-06-06,Southwest,356,113,243,111,2,15,3,12,3,0,Greater MN,2022-07-14
2021-06-06,State,8054,6019,2035,5865,154,1376,1022,354,963,59,State,2022-07-14
2021-06-06,West Central,208,80,128,80,0,20,9,11,9,0,Greater MN,2022-07-14
2022-06-06,Central,641,582,59,555,27,98,74,24,70,4,Greater MN,2022-07-14
2022-06-06,Metro,3816,3616,200,3380,236,766,632,134,606,26,Metro,2022-07-14
2022-06-06,Northeast,733,508,225,479,29,112,69,43,63,6,Greater MN,2022-07-14
2022-06-06,Northwest,257,152,105,144,8,25,15,10,14,1,Greater MN,2022-07-14
2022-06-06,South Central,310,189,121,176,13,22,6,16,6,0,Greater MN,2022-07-14
2022-06-06,Southeast,1282,978,304,938,40,251,161,90,156,5,Greater MN,2022-07-14
2022-06-06,Southwest,307,101,206,99,2,11,1,10,1,0,Greater MN,2022-07-14
2022-06-06,State,7497,6205,1292,5846,359,1292,958,334,916,42,State,2022-07-14
2022-06-06,West Central,151,79,72,75,4,7,0,7,0,0,Greater MN,2022-07-14
2021-06-07,Central,785,593,192,569,24,107,71,36,66,5,Greater MN,2022-07-14
2021-06-07,Metro,3776,3405,371,3326,79,799,674,125,639,35,Metro,2022-07-14
2021-06-07,Northeast,964,510,454,488,22,114,82,32,73,9,Greater MN,2022-07-14
2021-06-07,Northwest,334,154,180,148,6,31,13,18,10,3,Greater MN,2022-07-14
2021-06-07,South Central,363,195,168,191,4,23,10,13,9,1,Greater MN,2022-07-14
2021-06-07,Southeast,1252,916,336,910,6,255,153,102,150,3,Greater MN,2022-07-14
2021-06-07,Southwest,357,109,248,106,3,14,1,13,1,0,Greater MN,2022-07-14
2021-06-07,State,8039,5975,2064,5831,144,1363,1012,351,955,57,State,2022-07-14
2021-06-07,West Central,208,93,115,93,0,20,8,12,7,1,Greater MN,2022-07-14
2022-06-07,Central,690,638,52,602,36,96,76,20,71,5,Greater MN,2022-07-14
2022-06-07,Metro,4005,3858,147,3611,247,758,651,107,623,28,Metro,2022-07-14
2022-06-07,Northeast,733,517,216,498,19,113,69,44,61,8,Greater MN,2022-07-14
2022-06-07,Northwest,258,155,103,150,5,24,16,8,13,3,Greater MN,2022-07-14
2022-06-07,South Central,310,220,90,206,14,22,10,12,10,0,Greater MN,2022-07-14
2022-06-07,Southeast,1290,1045,245,1000,45,254,174,80,165,9,Greater MN,2022-07-14
2022-06-07,Southwest,317,119,198,117,2,11,1,10,1,0,Greater MN,2022-07-14
2022-06-07,State,7764,6650,1114,6280,370,1286,998,288,945,53,State,2022-07-14
2022-06-07,West Central,161,98,63,96,2,8,1,7,1,0,Greater MN,2022-07-14
2021-06-08,Central,806,652,154,632,20,114,78,36,72,6,Greater MN,2022-07-14
2021-06-08,Metro,3920,3662,258,3576,86,840,710,130,680,30,Metro,2022-07-14
2021-06-08,Northeast,959,545,414,527,18,113,82,31,72,10,Greater MN,2022-07-14
2021-06-08,Northwest,334,176,158,170,6,31,15,16,12,3,Greater MN,2022-07-14
2021-06-08,South Central,365,214,151,210,4,24,10,14,9,1,Greater MN,2022-07-14
2021-06-08,Southeast,1252,1015,237,1009,6,255,178,77,175,3,Greater MN,2022-07-14
2021-06-08,Southwest,364,118,246,116,2,15,1,14,1,0,Greater MN,2022-07-14
2021-06-08,State,8209,6498,1711,6356,142,1411,1081,330,1027,54,State,2022-07-14
2021-06-08,West Central,209,116,93,116,0,19,7,12,6,1,Greater MN,2022-07-14
2022-06-08,Central,709,631,78,601,30,100,81,19,76,5,Greater MN,2022-07-14
2022-06-08,Metro,4235,4077,158,3838,239,761,640,121,617,23,Metro,2022-07-14
2022-06-08,Northeast,737,551,186,523,28,113,66,47,59,7,Greater MN,2022-07-14
2022-06-08,Northwest,274,174,100,171,3,24,17,7,14,3,Greater MN,2022-07-14
2022-06-08,South Central,312,224,88,208,16,22,10,12,10,0,Greater MN,2022-07-14
2022-06-08,Southeast,1282,1044,238,1004,40,255,177,78,169,8,Greater MN,2022-07-14
2022-06-08,Southwest,314,124,190,121,3,11,1,10,1,0,Greater MN,2022-07-14
2022-06-08,State,8055,6950,1105,6588,362,1295,998,297,951,47,State,2022-07-14
2022-06-08,West Central,192,125,67,122,3,9,6,3,5,1,Greater MN,2022-07-14
2021-06-09,Central,841,693,148,677,16,120,88,32,82,6,Greater MN,2022-07-14
2021-06-09,Metro,4157,3879,278,3786,93,843,713,130,682,31,Metro,2022-07-14
2021-06-09,Northeast,960,558,402,538,20,113,89,24,79,10,Greater MN,2022-07-14
2021-06-09,Northwest,350,186,164,180,6,31,18,13,16,2,Greater MN,2022-07-14
2021-06-09,South Central,363,226,137,222,4,24,9,15,8,1,Greater MN,2022-07-14
2021-06-09,Southeast,1281,1060,221,1054,6,258,181,77,177,4,Greater MN,2022-07-14
2021-06-09,Southwest,385,133,252,131,2,16,2,14,2,0,Greater MN,2022-07-14
2021-06-09,State,8578,6868,1710,6721,147,1424,1108,316,1052,56,State,2022-07-14
2021-06-09,West Central,241,133,108,133,0,19,8,11,6,2,Greater MN,2022-07-14
2022-06-09,Central,666,591,75,560,31,97,72,25,67,5,Greater MN,2022-07-14
2022-06-09,Metro,4074,3961,113,3724,237,754,640,114,621,19,Metro,2022-07-14
2022-06-09,Northeast,738,524,214,495,29,107,65,42,59,6,Greater MN,2022-07-14
2022-06-09,Northwest,261,161,100,154,7,24,10,14,9,1,Greater MN,2022-07-14
2022-06-09,South Central,318,218,100,207,11,22,9,13,9,0,Greater MN,2022-07-14
2022-06-09,Southeast,1277,1083,194,1039,44,253,188,65,182,6,Greater MN,2022-07-14
2022-06-09,Southwest,307,114,193,107,7,12,3,9,3,0,Greater MN,2022-07-14
2022-06-09,State,7790,6729,1061,6359,370,1280,994,286,956,38,State,2022-07-14
2022-06-09,West Central,149,77,72,73,4,11,7,4,6,1,Greater MN,2022-07-14
2021-06-10,Central,805,632,173,619,13,124,91,33,85,6,Greater MN,2022-07-14
2021-06-10,Metro,4038,3753,285,3665,88,828,712,116,685,27,Metro,2022-07-14
2021-06-10,Northeast,957,572,385,553,19,113,83,30,76,7,Greater MN,2022-07-14
2021-06-10,Northwest,334,165,169,160,5,31,11,20,9,2,Greater MN,2022-07-14
2021-06-10,South Central,367,241,126,239,2,23,10,13,9,1,Greater MN,2022-07-14
2021-06-10,Southeast,1265,1081,184,1076,5,256,185,71,180,5,Greater MN,2022-07-14
2021-06-10,Southwest,370,136,234,134,2,15,2,13,2,0,Greater MN,2022-07-14
2021-06-10,State,8345,6685,1660,6550,135,1409,1103,306,1054,49,State,2022-07-14
2021-06-10,West Central,209,105,104,104,1,19,9,10,8,1,Greater MN,2022-07-14
2022-06-10,Central,673,603,70,567,36,99,75,24,69,6,Greater MN,2022-07-14
2022-06-10,Metro,4047,3914,133,3670,244,752,646,106,631,15,Metro,2022-07-14
2022-06-10,Northeast,707,513,194,485,28,101,72,29,68,4,Greater MN,2022-07-14
2022-06-10,Northwest,263,150,113,145,5,22,11,11,11,0,Greater MN,2022-07-14
2022-06-10,South Central,313,206,107,200,6,22,9,13,8,1,Greater MN,2022-07-14
2022-06-10,Southeast,1283,1046,237,1000,46,254,188,66,185,3,Greater MN,2022-07-14
2022-06-10,Southwest,312,126,186,120,6,12,2,10,2,0,Greater MN,2022-07-14
2022-06-10,State,7745,6633,1112,6258,375,1272,1009,263,980,29,State,2022-07-14
2022-06-10,West Central,147,75,72,71,4,10,6,4,6,0,Greater MN,2022-07-14
2021-06-11,Central,787,623,164,605,18,123,89,34,84,5,Greater MN,2022-07-14
2021-06-11,Metro,3988,3771,217,3687,84,809,687,122,660,27,Metro,2022-07-14
2021-06-11,Northeast,960,544,416,531,13,113,82,31,75,7,Greater MN,2022-07-14
2021-06-11,Northwest,334,160,174,156,4,31,14,17,12,2,Greater MN,2022-07-14
2021-06-11,South Central,364,222,142,220,2,24,11,13,9,2,Greater MN,2022-07-14
2021-06-11,Southeast,1277,1071,206,1065,6,255,175,80,170,5,Greater MN,2022-07-14
2021-06-11,Southwest,373,135,238,133,2,13,1,12,1,0,Greater MN,2022-07-14
2021-06-11,State,8292,6631,1661,6501,130,1387,1067,320,1018,49,State,2022-07-14
2021-06-11,West Central,209,105,104,104,1,19,8,11,7,1,Greater MN,2022-07-14
2022-06-11,Central,654,597,57,563,34,90,66,24,62,4,Greater MN,2022-07-14
2022-06-11,Metro,3916,3730,186,3507,223,764,673,91,654,19,Metro,2022-07-14
2022-06-11,Northeast,752,506,246,472,34,99,69,30,63,6,Greater MN,2022-07-14
2022-06-11,Northwest,259,140,119,136,4,23,15,8,14,1,Greater MN,2022-07-14
2022-06-11,South Central,301,187,114,178,9,22,10,12,9,1,Greater MN,2022-07-14
2022-06-11,Southeast,1283,1030,253,990,40,253,174,79,172,2,Greater MN,2022-07-14
2022-06-11,Southwest,302,120,182,116,4,10,0,10,0,0,Greater MN,2022-07-14
2022-06-11,State,7604,6382,1222,6031,351,1271,1011,260,977,34,State,2022-07-14
2022-06-11,West Central,137,72,65,69,3,10,4,6,3,1,Greater MN,2022-07-14
2021-06-12,Central,766,583,183,566,17,118,83,35,78,5,Greater MN,2022-07-14
2021-06-12,Metro,3901,3631,270,3553,78,815,683,132,658,25,Metro,2022-07-14
2021-06-12,Northeast,961,504,457,493,11,114,88,26,81,7,Greater MN,2022-07-14
2021-06-12,Northwest,334,160,174,157,3,31,17,14,15,2,Greater MN,2022-07-14
2021-06-12,South Central,358,205,153,202,3,24,9,15,7,2,Greater MN,2022-07-14
2021-06-12,Southeast,1285,1028,257,1024,4,257,174,83,170,4,Greater MN,2022-07-14
2021-06-12,Southwest,362,116,246,115,1,14,3,11,3,0,Greater MN,2022-07-14
2021-06-12,State,8176,6329,1847,6211,118,1392,1064,328,1018,46,State,2022-07-14
2021-06-12,West Central,209,102,107,101,1,19,7,12,6,1,Greater MN,2022-07-14
2022-06-12,Central,623,554,69,514,40,91,65,26,63,2,Greater MN,2022-07-14
2022-06-12,Metro,3816,3674,142,3456,218,757,657,100,637,20,Metro,2022-07-14
2022-06-12,Northeast,738,489,249,452,37,100,73,27,66,7,Greater MN,2022-07-14
2022-06-12,Northwest,260,153,107,149,4,25,20,5,20,0,Greater MN,2022-07-14
2022-06-12,South Central,303,183,120,171,12,22,8,14,8,0,Greater MN,2022-07-14
2022-06-12,Southeast,1281,995,286,954,41,254,161,93,158,3,Greater MN,2022-07-14
2022-06-12,Southwest,302,114,188,111,3,10,0,10,0,0,Greater MN,2022-07-14
2022-06-12,State,7465,6228,1237,5869,359,1269,987,282,955,32,State,2022-07-14
2022-06-12,West Central,142,66,76,62,4,10,3,7,3,0,Greater MN,2022-07-14
2021-06-13,Central,757,558,199,543,15,111,77,34,72,5,Greater MN,2022-07-14
2021-06-13,Metro,3758,3464,294,3399,65,789,667,122,642,25,Metro,2022-07-14
2021-06-13,Northeast,958,494,464,483,11,114,81,33,73,8,Greater MN,2022-07-14
2021-06-13,Northwest,334,156,178,153,3,31,12,19,11,1,Greater MN,2022-07-14
2021-06-13,South Central,360,214,146,212,2,24,9,15,7,2,Greater MN,2022-07-14
2021-06-13,Southeast,1283,920,363,916,4,257,151,106,146,5,Greater MN,2022-07-14
2021-06-13,Southwest,357,118,239,116,2,14,1,13,1,0,Greater MN,2022-07-14
2021-06-13,State,8016,6014,2002,5910,104,1359,1002,357,956,46,State,2022-07-14
2021-06-13,West Central,209,90,119,88,2,19,4,15,4,0,Greater MN,2022-07-14
2022-06-13,Central,646,572,74,530,42,92,71,21,68,3,Greater MN,2022-07-14
2022-06-13,Metro,3924,3715,209,3492,223,758,663,95,637,26,Metro,2022-07-14
2022-06-13,Northeast,733,478,255,443,35,107,77,30,71,6,Greater MN,2022-07-14
2022-06-13,Northwest,261,149,112,143,6,24,19,5,19,0,Greater MN,2022-07-14
2022-06-13,South Central,304,179,125,167,12,22,9,13,8,1,Greater MN,2022-07-14
2022-06-13,Southeast,1280,968,312,935,33,256,155,101,149,6,Greater MN,2022-07-14
2022-06-13,Southwest,305,119,186,115,4,10,1,9,1,0,Greater MN,2022-07-14
2022-06-13,State,7604,6260,1344,5898,362,1277,997,280,955,42,State,2022-07-14
2022-06-13,West Central,151,80,71,73,7,8,2,6,2,0,Greater MN,2022-07-14
2021-06-14,Central,764,560,204,543,17,100,67,33,63,4,Greater MN,2022-07-14
2021-06-14,Metro,3716,3375,341,3321,54,781,656,125,626,30,Metro,2022-07-14
2021-06-14,Northeast,957,495,462,482,13,114,93,21,84,9,Greater MN,2022-07-14
2021-06-14,Northwest,334,165,169,161,4,31,16,15,16,0,Greater MN,2022-07-14
2021-06-14,South Central,363,192,171,189,3,24,8,16,7,1,Greater MN,2022-07-14
2021-06-14,Southeast,1272,886,386,882,4,256,140,116,135,5,Greater MN,2022-07-14
2021-06-14,Southwest,364,106,258,105,1,14,1,13,1,0,Greater MN,2022-07-14
2021-06-14,State,7979,5883,2096,5785,98,1339,986,353,937,49,State,2022-07-14
2021-06-14,West Central,209,104,105,102,2,19,5,14,5,0,Greater MN,2022-07-14
2022-06-14,Central,648,583,65,539,44,91,67,24,64,3,Greater MN,2022-07-14
2022-06-14,Metro,4002,3877,125,3633,244,777,669,108,641,28,Metro,2022-07-14
2022-06-14,Northeast,742,523,219,488,35,99,73,26,69,4,Greater MN,2022-07-14
2022-06-14,Northwest,255,154,101,145,9,25,15,10,14,1,Greater MN,2022-07-14
2022-06-14,South Central,314,187,127,178,9,22,9,13,8,1,Greater MN,2022-07-14
2022-06-14,Southeast,1275,1048,227,1012,36,256,170,86,166,4,Greater MN,2022-07-14
2022-06-14,Southwest,303,129,174,125,4,11,0,11,0,0,Greater MN,2022-07-14
2022-06-14,State,7696,6598,1098,6210,388,1290,1006,284,965,41,State,2022-07-14
2022-06-14,West Central,157,97,60,90,7,9,3,6,3,0,Greater MN,2022-07-14
2021-06-15,Central,809,640,169,628,12,112,75,37,72,3,Greater MN,2022-07-14
2021-06-15,Metro,3906,3649,257,3588,61,812,679,133,651,28,Metro,2022-07-14
2021-06-15,Northeast,958,507,451,493,14,114,74,40,65,9,Greater MN,2022-07-14
2021-06-15,Northwest,334,167,167,163,4,31,17,14,16,1,Greater MN,2022-07-14
2021-06-15,South Central,362,207,155,205,2,24,8,16,5,3,Greater MN,2022-07-14
2021-06-15,Southeast,1282,993,289,988,5,256,160,96,155,5,Greater MN,2022-07-14
2021-06-15,Southwest,371,119,252,118,1,15,3,12,3,0,Greater MN,2022-07-14
2021-06-15,State,8231,6391,1840,6289,102,1383,1020,363,971,49,State,2022-07-14
2021-06-15,West Central,209,109,100,106,3,19,4,15,4,0,Greater MN,2022-07-14
2022-06-15,Central,706,638,68,587,51,84,65,19,61,4,Greater MN,2022-07-14
2022-06-15,Metro,4266,4080,186,3854,226,786,672,114,642,30,Metro,2022-07-14
2022-06-15,Northeast,748,534,214,501,33,99,70,29,67,3,Greater MN,2022-07-14
2022-06-15,Northwest,270,147,123,139,8,26,21,5,19,2,Greater MN,2022-07-14
2022-06-15,South Central,316,196,120,186,10,22,12,10,12,0,Greater MN,2022-07-14
2022-06-15,Southeast,1294,1067,227,1036,31,257,180,77,176,4,Greater MN,2022-07-14
2022-06-15,Southwest,313,129,184,124,5,9,1,8,1,0,Greater MN,2022-07-14
2022-06-15,State,8100,6916,1184,6543,373,1293,1026,267,983,43,State,2022-07-14
2022-06-15,West Central,187,125,62,116,9,10,5,5,5,0,Greater MN,2022-07-14
2021-06-16,Central,843,665,178,653,12,109,71,38,66,5,Greater MN,2022-07-14
2021-06-16,Metro,4128,3871,257,3804,67,813,673,140,648,25,Metro,2022-07-14
2021-06-16,Northeast,962,524,438,511,13,114,73,41,64,9,Greater MN,2022-07-14
2021-06-16,Northwest,351,184,167,181,3,31,16,15,16,0,Greater MN,2022-07-14
2021-06-16,South Central,370,208,162,202,6,24,8,16,8,0,Greater MN,2022-07-14
2021-06-16,Southeast,1288,1052,236,1048,4,257,170,87,165,5,Greater MN,2022-07-14
2021-06-16,Southwest,383,121,262,120,1,14,4,10,4,0,Greater MN,2022-07-14
2021-06-16,State,8566,6768,1798,6659,109,1381,1023,358,979,44,State,2022-07-14
2021-06-16,West Central,241,143,98,140,3,19,8,11,8,0,Greater MN,2022-07-14
2022-06-16,Central,661,604,57,560,44,94,71,23,64,7,Greater MN,2022-07-14
2022-06-16,Metro,4070,3939,131,3727,212,788,684,104,660,24,Metro,2022-07-14
2022-06-16,Northeast,727,520,207,490,30,99,71,28,67,4,Greater MN,2022-07-14
2022-06-16,Northwest,254,149,105,140,9,28,22,6,22,0,Greater MN,2022-07-14
2022-06-16,South Central,316,215,101,202,13,22,11,11,11,0,Greater MN,2022-07-14
2022-06-16,Southeast,1284,1064,220,1035,29,256,191,65,187,4,Greater MN,2022-07-14
2022-06-16,Southwest,313,129,184,121,8,9,2,7,2,0,Greater MN,2022-07-14
2022-06-16,State,7783,6718,1065,6364,354,1305,1057,248,1018,39,State,2022-07-14
2022-06-16,West Central,158,98,60,89,9,9,5,4,5,0,Greater MN,2022-07-14
2021-06-17,Central,810,657,153,648,9,114,76,38,71,5,Greater MN,2022-07-14
2021-06-17,Metro,4116,3843,273,3783,60,796,645,151,620,25,Metro,2022-07-14
2021-06-17,Northeast,959,556,403,546,10,114,73,41,65,8,Greater MN,2022-07-14
2021-06-17,Northwest,334,168,166,165,3,31,17,14,17,0,Greater MN,2022-07-14
2021-06-17,South Central,370,200,170,195,5,24,9,15,9,0,Greater MN,2022-07-14
2021-06-17,Southeast,1270,1064,206,1061,3,257,187,70,184,3,Greater MN,2022-07-14
2021-06-17,Southwest,361,127,234,126,1,13,2,11,2,0,Greater MN,2022-07-14
2021-06-17,State,8429,6727,1702,6634,93,1368,1018,350,977,41,State,2022-07-14
2021-06-17,West Central,209,112,97,110,2,19,9,10,9,0,Greater MN,2022-07-14
2022-06-17,Central,663,595,68,551,44,97,73,24,65,8,Greater MN,2022-07-14
2022-06-17,Metro,4055,3894,161,3674,220,783,661,122,641,20,Metro,2022-07-14
2022-06-17,Northeast,746,520,226,489,31,99,61,38,58,3,Greater MN,2022-07-14
2022-06-17,Northwest,253,138,115,132,6,26,21,5,20,1,Greater MN,2022-07-14
2022-06-17,South Central,307,202,105,195,7,22,8,14,8,0,Greater MN,2022-07-14
2022-06-17,Southeast,1284,1057,227,1031,26,255,181,74,177,4,Greater MN,2022-07-14
2022-06-17,Southwest,304,123,181,119,4,9,1,8,1,0,Greater MN,2022-07-14
2022-06-17,State,7767,6619,1148,6274,345,1302,1012,290,976,36,State,2022-07-14
2022-06-17,West Central,155,90,65,83,7,11,6,5,6,0,Greater MN,2022-07-14
2021-06-18,Central,786,618,168,609,9,115,81,34,77,4,Greater MN,2022-07-14
2021-06-18,Metro,4034,3834,200,3775,59,805,648,157,622,26,Metro,2022-07-14
2021-06-18,Northeast,957,548,409,536,12,114,82,32,74,8,Greater MN,2022-07-14
2021-06-18,Northwest,334,167,167,165,2,31,15,16,13,2,Greater MN,2022-07-14
2021-06-18,South Central,362,200,162,194,6,24,10,14,10,0,Greater MN,2022-07-14
2021-06-18,Southeast,1278,1061,217,1057,4,259,174,85,171,3,Greater MN,2022-07-14
2021-06-18,Southwest,362,116,246,114,2,10,1,9,1,0,Greater MN,2022-07-14
2021-06-18,State,8322,6651,1671,6556,95,1377,1019,358,975,44,State,2022-07-14
2021-06-18,West Central,209,107,102,106,1,19,8,11,7,1,Greater MN,2022-07-14
2022-06-18,Central,633,568,65,529,39,88,63,25,58,5,Greater MN,2022-07-14
2022-06-18,Metro,3988,3819,169,3607,212,756,633,123,614,19,Metro,2022-07-14
2022-06-18,Northeast,741,496,245,464,32,99,58,41,55,3,Greater MN,2022-07-14
2022-06-18,Northwest,253,134,119,129,5,27,21,6,20,1,Greater MN,2022-07-14
2022-06-18,South Central,310,184,126,175,9,22,7,15,7,0,Greater MN,2022-07-14
2022-06-18,Southeast,1292,1012,280,988,24,258,180,78,178,2,Greater MN,2022-07-14
2022-06-18,Southwest,302,106,196,103,3,9,1,8,1,0,Greater MN,2022-07-14
2022-06-18,State,7687,6411,1276,6080,331,1268,967,301,937,30,State,2022-07-14
2022-06-18,West Central,168,92,76,85,7,9,4,5,4,0,Greater MN,2022-07-14
2021-06-19,Central,796,607,189,597,10,109,72,37,70,2,Greater MN,2022-07-14
2021-06-19,Metro,3858,3593,265,3540,53,788,630,158,608,22,Metro,2022-07-14
2021-06-19,Northeast,956,505,451,491,14,114,77,37,68,9,Greater MN,2022-07-14
2021-06-19,Northwest,334,153,181,151,2,31,13,18,11,2,Greater MN,2022-07-14
2021-06-19,South Central,359,196,163,191,5,24,9,15,9,0,Greater MN,2022-07-14
2021-06-19,Southeast,1279,984,295,979,5,258,166,92,164,2,Greater MN,2022-07-14
2021-06-19,Southwest,357,110,247,107,3,11,2,9,2,0,Greater MN,2022-07-14
2021-06-19,State,8147,6231,1916,6139,92,1355,976,379,938,38,State,2022-07-14
2021-06-19,West Central,208,83,125,83,0,20,7,13,6,1,Greater MN,2022-07-14
2022-06-19,Central,629,552,77,517,35,83,58,25,54,4,Greater MN,2022-07-14
2022-06-19,Metro,3795,3666,129,3454,212,773,627,146,608,19,Metro,2022-07-14
2022-06-19,Northeast,754,477,277,438,39,103,62,41,57,5,Greater MN,2022-07-14
2022-06-19,Northwest,255,114,141,110,4,23,19,4,18,1,Greater MN,2022-07-14
2022-06-19,South Central,304,191,113,178,13,22,8,14,8,0,Greater MN,2022-07-14
2022-06-19,Southeast,1278,981,297,952,29,255,155,100,150,5,Greater MN,2022-07-14
2022-06-19,Southwest,300,113,187,109,4,9,0,9,-1,1,Greater MN,2022-07-14
2022-06-19,State,7470,6157,1313,5818,339,1276,930,346,895,35,State,2022-07-14
2022-06-19,West Central,155,63,92,60,3,8,1,7,1,0,Greater MN,2022-07-14
2021-06-20,Central,749,565,184,558,7,99,58,41,56,2,Greater MN,2022-07-14
2021-06-20,Metro,3690,3439,251,3389,50,789,617,172,597,20,Metro,2022-07-14
2021-06-20,Northeast,955,484,471,472,12,114,69,45,63,6,Greater MN,2022-07-14
2021-06-20,Northwest,334,149,185,147,2,31,12,19,10,2,Greater MN,2022-07-14
2021-06-20,South Central,358,201,157,196,5,24,8,16,8,0,Greater MN,2022-07-14
2021-06-20,Southeast,1273,880,393,877,3,254,159,95,157,2,Greater MN,2022-07-14
2021-06-20,Southwest,367,105,262,102,3,11,0,11,0,0,Greater MN,2022-07-14
2021-06-20,State,7934,5889,2045,5805,84,1342,927,415,895,32,State,2022-07-14
2021-06-20,West Central,208,66,142,64,2,20,4,16,4,0,Greater MN,2022-07-14
2022-06-20,Central,622,540,82,510,30,84,59,25,54,5,Greater MN,2022-07-14
2022-06-20,Metro,3879,3691,188,3476,215,760,641,119,620,21,Metro,2022-07-14
2022-06-20,Northeast,742,482,260,441,41,96,68,28,64,4,Greater MN,2022-07-14
2022-06-20,Northwest,253,122,131,118,4,23,19,4,18,1,Greater MN,2022-07-14
2022-06-20,South Central,308,190,118,177,13,22,12,10,12,0,Greater MN,2022-07-14
2022-06-20,Southeast,1283,961,322,932,29,253,148,105,141,7,Greater MN,2022-07-14
2022-06-20,Southwest,301,109,192,103,6,9,3,6,2,1,Greater MN,2022-07-14
2022-06-20,State,7537,6168,1369,5827,341,1256,954,302,915,39,State,2022-07-14
2022-06-20,West Central,149,73,76,70,3,9,4,5,4,0,Greater MN,2022-07-14
2021-06-21,Central,756,562,194,554,8,101,60,41,58,2,Greater MN,2022-07-14
2021-06-21,Metro,3718,3363,355,3304,59,800,623,177,605,18,Metro,2022-07-14
2021-06-21,Northeast,963,513,450,501,12,114,80,34,73,7,Greater MN,2022-07-14
2021-06-21,Northwest,334,154,180,152,2,31,12,19,10,2,Greater MN,2022-07-14
2021-06-21,South Central,363,201,162,196,5,26,12,14,12,0,Greater MN,2022-07-14
2021-06-21,Southeast,1264,884,380,884,0,255,153,102,150,3,Greater MN,2022-07-14
2021-06-21,Southwest,359,100,259,98,2,15,3,12,3,0,Greater MN,2022-07-14
2021-06-21,State,7965,5847,2118,5758,89,1362,947,415,915,32,State,2022-07-14
2021-06-21,West Central,208,70,138,69,1,20,4,16,4,0,Greater MN,2022-07-14
2022-06-21,Central,669,622,47,592,30,94,69,25,66,3,Greater MN,2022-07-14
2022-06-21,Metro,4027,3879,148,3662,217,785,662,123,639,23,Metro,2022-07-14
2022-06-21,Northeast,747,494,253,452,42,99,75,24,71,4,Greater MN,2022-07-14
2022-06-21,Northwest,254,136,118,132,4,24,20,4,19,1,Greater MN,2022-07-14
2022-06-21,South Central,312,201,111,188,13,22,11,11,11,0,Greater MN,2022-07-14
2022-06-21,Southeast,1282,1023,259,998,25,251,164,87,160,4,Greater MN,2022-07-14
2022-06-21,Southwest,311,130,181,126,4,9,4,5,3,1,Greater MN,2022-07-14
2022-06-21,State,7754,6568,1186,6231,337,1293,1010,283,974,36,State,2022-07-14
2022-06-21,West Central,152,83,69,81,2,9,5,4,5,0,Greater MN,2022-07-14
2021-06-22,Central,760,605,155,599,6,101,62,39,60,2,Greater MN,2022-07-14
2021-06-22,Metro,3841,3587,254,3529,58,808,646,162,629,17,Metro,2022-07-14
2021-06-22,Northeast,964,524,440,515,9,114,82,32,76,6,Greater MN,2022-07-14
2021-06-22,Northwest,334,159,175,157,2,31,13,18,11,2,Greater MN,2022-07-14
2021-06-22,South Central,365,214,151,208,6,23,10,13,10,0,Greater MN,2022-07-14
2021-06-22,Southeast,1271,968,303,968,0,258,161,97,157,4,Greater MN,2022-07-14
2021-06-22,Southwest,383,130,253,129,1,11,4,7,4,0,Greater MN,2022-07-14
2021-06-22,State,8126,6269,1857,6187,82,1366,985,381,954,31,State,2022-07-14
2021-06-22,West Central,208,82,126,82,0,20,7,13,7,0,Greater MN,2022-07-14
2022-06-22,Central,725,687,38,657,30,96,73,23,72,1,Greater MN,2022-07-14
2022-06-22,Metro,4260,4094,166,3866,228,768,674,94,654,20,Metro,2022-07-14
2022-06-22,Northeast,743,526,217,483,43,99,76,23,74,2,Greater MN,2022-07-14
2022-06-22,Northwest,267,162,105,157,5,29,23,6,20,3,Greater MN,2022-07-14
2022-06-22,South Central,317,194,123,185,9,22,8,14,8,0,Greater MN,2022-07-14
2022-06-22,Southeast,1296,1075,221,1043,32,249,173,76,167,6,Greater MN,2022-07-14
2022-06-22,Southwest,326,152,174,150,2,10,2,8,1,1,Greater MN,2022-07-14
2022-06-22,State,8123,7012,1111,6661,351,1282,1034,248,1001,33,State,2022-07-14
2022-06-22,West Central,189,122,67,120,2,9,5,4,5,0,Greater MN,2022-07-14
2021-06-23,Central,793,655,138,647,8,106,68,38,66,2,Greater MN,2022-07-14
2021-06-23,Metro,4096,3871,225,3810,61,808,640,168,622,18,Metro,2022-07-14
2021-06-23,Northeast,958,553,405,546,7,114,74,40,68,6,Greater MN,2022-07-14
2021-06-23,Northwest,350,168,182,167,1,31,14,17,12,2,Greater MN,2022-07-14
2021-06-23,South Central,368,227,141,221,6,24,10,14,9,1,Greater MN,2022-07-14
2021-06-23,Southeast,1289,1036,253,1034,2,254,158,96,155,3,Greater MN,2022-07-14
2021-06-23,Southwest,393,148,245,148,0,12,4,8,4,0,Greater MN,2022-07-14
2021-06-23,State,8487,6792,1695,6707,85,1369,974,395,942,32,State,2022-07-14
2021-06-23,West Central,240,134,106,134,0,20,6,14,6,0,Greater MN,2022-07-14
2022-06-23,Central,663,610,53,582,28,92,66,26,64,2,Greater MN,2022-07-14
2022-06-23,Metro,4035,3933,102,3695,238,775,668,107,646,22,Metro,2022-07-14
2022-06-23,Northeast,740,537,203,498,39,99,78,21,75,3,Greater MN,2022-07-14
2022-06-23,Northwest,257,171,86,166,5,26,21,5,19,2,Greater MN,2022-07-14
2022-06-23,South Central,310,202,108,193,9,22,12,10,12,0,Greater MN,2022-07-14
2022-06-23,Southeast,1280,1079,201,1047,32,251,164,87,158,6,Greater MN,2022-07-14
2022-06-23,Southwest,314,140,174,139,1,11,3,8,1,2,Greater MN,2022-07-14
2022-06-23,State,7759,6772,987,6416,356,1286,1016,270,979,37,State,2022-07-14
2022-06-23,West Central,160,100,60,96,4,10,4,6,4,0,Greater MN,2022-07-14
2021-06-24,Central,785,662,123,655,7,116,80,36,78,2,Greater MN,2022-07-14
2021-06-24,Metro,3984,3752,232,3699,53,813,659,154,644,15,Metro,2022-07-14
2021-06-24,Northeast,953,541,412,534,7,114,70,44,65,5,Greater MN,2022-07-14
2021-06-24,Northwest,334,169,165,168,1,31,13,18,11,2,Greater MN,2022-07-14
2021-06-24,South Central,366,219,147,211,8,24,10,14,9,1,Greater MN,2022-07-14
2021-06-24,Southeast,1279,1036,243,1033,3,251,163,88,161,2,Greater MN,2022-07-14
2021-06-24,Southwest,374,131,243,131,0,12,6,6,6,0,Greater MN,2022-07-14
2021-06-24,State,8283,6620,1663,6540,80,1381,1009,372,982,27,State,2022-07-14
2021-06-24,West Central,208,110,98,109,1,20,8,12,8,0,Greater MN,2022-07-14
2022-06-24,Central,657,606,51,583,23,99,75,24,72,3,Greater MN,2022-07-14
2022-06-24,Metro,4050,3899,151,3668,231,773,685,88,662,23,Metro,2022-07-14
2022-06-24,Northeast,762,524,238,487,37,97,77,20,72,5,Greater MN,2022-07-14
2022-06-24,Northwest,258,144,114,139,5,23,17,6,15,2,Greater MN,2022-07-14
2022-06-24,South Central,315,211,104,200,11,22,13,9,13,0,Greater MN,2022-07-14
2022-06-24,Southeast,1295,1085,210,1047,38,254,177,77,173,4,Greater MN,2022-07-14
2022-06-24,Southwest,313,128,185,124,4,11,3,8,2,1,Greater MN,2022-07-14
2022-06-24,State,7804,6671,1133,6319,352,1288,1050,238,1012,38,State,2022-07-14
2022-06-24,West Central,154,74,80,71,3,9,3,6,3,0,Greater MN,2022-07-14
2021-06-25,Central,765,644,121,637,7,116,79,37,77,2,Greater MN,2022-07-14
2021-06-25,Metro,3954,3745,209,3698,47,814,683,131,667,16,Metro,2022-07-14
2021-06-25,Northeast,958,554,404,548,6,114,72,42,68,4,Greater MN,2022-07-14
2021-06-25,Northwest,334,162,172,161,1,31,15,16,13,2,Greater MN,2022-07-14
2021-06-25,South Central,368,223,145,217,6,24,9,15,8,1,Greater MN,2022-07-14
2021-06-25,Southeast,1281,1044,237,1041,3,258,164,94,162,2,Greater MN,2022-07-14
2021-06-25,Southwest,368,127,241,127,0,13,4,9,4,0,Greater MN,2022-07-14
2021-06-25,State,8236,6611,1625,6540,71,1390,1033,357,1006,27,State,2022-07-14
2021-06-25,West Central,208,112,96,111,1,20,7,13,7,0,Greater MN,2022-07-14
2022-06-25,Central,628,551,77,531,20,96,70,26,68,2,Greater MN,2022-07-14
2022-06-25,Metro,3946,3814,132,3592,222,772,658,114,640,18,Metro,2022-07-14
2022-06-25,Northeast,742,499,243,464,35,96,68,28,64,4,Greater MN,2022-07-14
2022-06-25,Northwest,254,134,120,129,5,24,19,5,16,3,Greater MN,2022-07-14
2022-06-25,South Central,313,203,110,192,11,22,10,12,10,0,Greater MN,2022-07-14
2022-06-25,Southeast,1285,1070,215,1033,37,256,165,91,161,4,Greater MN,2022-07-14
2022-06-25,Southwest,303,103,200,99,4,10,2,8,2,0,Greater MN,2022-07-14
2022-06-25,State,7624,6441,1183,6104,337,1285,996,289,965,31,State,2022-07-14
2022-06-25,West Central,153,67,86,64,3,9,4,5,4,0,Greater MN,2022-07-14
2021-06-26,Central,734,577,157,567,10,109,72,37,69,3,Greater MN,2022-07-14
2021-06-26,Metro,3848,3580,268,3533,47,806,662,144,647,15,Metro,2022-07-14
2021-06-26,Northeast,960,548,412,543,5,114,76,38,72,4,Greater MN,2022-07-14
2021-06-26,Northwest,334,147,187,146,1,31,13,18,11,2,Greater MN,2022-07-14
2021-06-26,South Central,366,211,155,207,4,24,10,14,9,1,Greater MN,2022-07-14
2021-06-26,Southeast,1275,974,301,971,3,253,164,89,162,2,Greater MN,2022-07-14
2021-06-26,Southwest,352,108,244,108,0,13,3,10,3,0,Greater MN,2022-07-14
2021-06-26,State,8077,6227,1850,6156,71,1370,1006,364,979,27,State,2022-07-14
2021-06-26,West Central,208,82,126,81,1,20,6,14,6,0,Greater MN,2022-07-14
2022-06-26,Central,652,568,84,546,22,96,72,24,70,2,Greater MN,2022-07-14
2022-06-26,Metro,3813,3646,167,3431,215,747,630,117,613,17,Metro,2022-07-14
2022-06-26,Northeast,752,492,260,453,39,93,68,25,64,4,Greater MN,2022-07-14
2022-06-26,Northwest,252,125,127,120,5,27,21,6,19,2,Greater MN,2022-07-14
2022-06-26,South Central,312,207,105,193,14,22,12,10,12,0,Greater MN,2022-07-14
2022-06-26,Southeast,1268,991,277,957,34,257,155,102,151,4,Greater MN,2022-07-14
2022-06-26,Southwest,302,104,198,99,5,10,1,9,1,0,Greater MN,2022-07-14
2022-06-26,State,7503,6189,1314,5851,338,1262,961,301,932,29,State,2022-07-14
2022-06-26,West Central,152,56,96,52,4,10,2,8,2,0,Greater MN,2022-07-14
2021-06-27,Central,794,598,196,590,8,101,61,40,59,2,Greater MN,2022-07-14
2021-06-27,Metro,3693,3489,204,3441,48,802,654,148,638,16,Metro,2022-07-14
2021-06-27,Northeast,959,533,426,526,7,114,76,38,73,3,Greater MN,2022-07-14
2021-06-27,Northwest,334,148,186,147,1,31,15,16,13,2,Greater MN,2022-07-14
2021-06-27,South Central,365,206,159,201,5,22,9,13,8,1,Greater MN,2022-07-14
2021-06-27,Southeast,1273,888,385,883,5,252,161,91,159,2,Greater MN,2022-07-14
2021-06-27,Southwest,359,90,269,90,0,13,4,9,4,0,Greater MN,2022-07-14
2021-06-27,State,7985,6039,1946,5965,74,1355,986,369,960,26,State,2022-07-14
2021-06-27,West Central,208,87,121,87,0,20,6,14,6,0,Greater MN,2022-07-14
2022-06-27,Central,638,567,71,547,20,98,74,24,72,2,Greater MN,2022-07-14
2022-06-27,Metro,4014,3619,395,3393,226,751,649,102,627,22,Metro,2022-07-14
2022-06-27,Northeast,752,502,250,460,42,96,70,26,66,4,Greater MN,2022-07-14
2022-06-27,Northwest,255,130,125,125,5,27,19,8,18,1,Greater MN,2022-07-14
2022-06-27,South Central,319,213,106,197,16,22,8,14,8,0,Greater MN,2022-07-14
2022-06-27,Southeast,1257,958,299,928,30,254,162,92,158,4,Greater MN,2022-07-14
2022-06-27,Southwest,302,111,191,104,7,10,1,9,1,0,Greater MN,2022-07-14
2022-06-27,State,7686,6151,1535,5803,348,1268,986,282,953,33,State,2022-07-14
2022-06-27,West Central,149,51,98,49,2,10,3,7,3,0,Greater MN,2022-07-14
2021-06-28,Central,800,651,149,644,7,107,68,39,66,2,Greater MN,2022-07-14
2021-06-28,Metro,3735,3479,256,3430,49,795,639,156,625,14,Metro,2022-07-14
2021-06-28,Northeast,960,529,431,523,6,114,80,34,77,3,Greater MN,2022-07-14
2021-06-28,Northwest,334,156,178,155,1,31,14,17,12,2,Greater MN,2022-07-14
2021-06-28,South Central,361,200,161,197,3,24,10,14,9,1,Greater MN,2022-07-14
2021-06-28,Southeast,1254,891,363,884,7,250,147,103,146,1,Greater MN,2022-07-14
2021-06-28,Southwest,371,94,277,94,0,13,3,10,3,0,Greater MN,2022-07-14
2021-06-28,State,8023,6085,1938,6011,74,1354,969,385,946,23,State,2022-07-14
2021-06-28,West Central,208,85,123,84,1,20,8,12,8,0,Greater MN,2022-07-14
2022-06-28,Central,670,621,49,598,23,95,73,22,72,1,Greater MN,2022-07-14
2022-06-28,Metro,4098,3701,397,3464,237,766,661,105,635,26,Metro,2022-07-14
2022-06-28,Northeast,765,512,253,468,44,100,70,30,67,3,Greater MN,2022-07-14
2022-06-28,Northwest,255,136,119,133,3,27,18,9,16,2,Greater MN,2022-07-14
2022-06-28,South Central,314,220,94,201,19,22,11,11,11,0,Greater MN,2022-07-14
2022-06-28,Southeast,1264,1032,232,999,33,252,168,84,163,5,Greater MN,2022-07-14
2022-06-28,Southwest,313,119,194,112,7,10,1,9,1,0,Greater MN,2022-07-14
2022-06-28,State,7838,6426,1412,6057,369,1283,1006,277,969,37,State,2022-07-14
2022-06-28,West Central,159,85,74,82,3,11,4,7,4,0,Greater MN,2022-07-14
2021-06-29,Central,817,685,132,680,5,107,67,40,65,2,Greater MN,2022-07-14
2021-06-29,Metro,3898,3694,204,3645,49,800,672,128,656,16,Metro,2022-07-14
2021-06-29,Northeast,965,566,399,558,8,114,74,40,72,2,Greater MN,2022-07-14
2021-06-29,Northwest,334,175,159,174,1,31,15,16,14,1,Greater MN,2022-07-14
2021-06-29,South Central,364,210,154,205,5,24,10,14,9,1,Greater MN,2022-07-14
2021-06-29,Southeast,1265,972,293,967,5,253,163,90,162,1,Greater MN,2022-07-14
2021-06-29,Southwest,372,120,252,120,0,12,3,9,3,0,Greater MN,2022-07-14
2021-06-29,State,8239,6526,1713,6452,74,1361,1009,352,986,23,State,2022-07-14
2021-06-29,West Central,224,104,120,103,1,20,5,15,5,0,Greater MN,2022-07-14
2022-06-29,Central,704,646,58,617,29,101,77,24,76,1,Greater MN,2022-07-14
2022-06-29,Metro,4284,4089,195,3847,242,774,657,117,627,30,Metro,2022-07-14
2022-06-29,Northeast,768,544,224,503,41,101,69,32,66,3,Greater MN,2022-07-14
2022-06-29,Northwest,277,158,119,154,4,24,16,8,14,2,Greater MN,2022-07-14
2022-06-29,South Central,320,204,116,190,14,23,13,10,13,0,Greater MN,2022-07-14
2022-06-29,Southeast,1282,1090,192,1063,27,250,178,72,172,6,Greater MN,2022-07-14
2022-06-29,Southwest,321,135,186,128,7,10,2,8,2,0,Greater MN,2022-07-14
2022-06-29,State,8148,6990,1158,6621,369,1294,1019,275,977,42,State,2022-07-14
2022-06-29,West Central,192,124,68,119,5,11,7,4,7,0,Greater MN,2022-07-14
2021-06-30,Central,826,673,153,669,4,116,78,38,76,2,Greater MN,2022-07-14
2021-06-30,Metro,4211,3912,299,3862,50,805,676,129,660,16,Metro,2022-07-14
2021-06-30,Northeast,961,574,387,567,7,114,79,35,77,2,Greater MN,2022-07-14
2021-06-30,Northwest,351,183,168,182,1,31,15,16,14,1,Greater MN,2022-07-14
2021-06-30,South Central,353,199,154,194,5,24,10,14,9,1,Greater MN,2022-07-14
2021-06-30,Southeast,1290,1036,254,1030,6,254,174,80,173,1,Greater MN,2022-07-14
2021-06-30,Southwest,397,139,258,139,0,12,5,7,5,0,Greater MN,2022-07-14
2021-06-30,State,8629,6832,1797,6757,75,1376,1047,329,1024,23,State,2022-07-14
2021-06-30,West Central,240,116,124,114,2,20,10,10,10,0,Greater MN,2022-07-14
2022-06-30,Central,657,599,58,563,36,98,76,22,74,2,Greater MN,2022-07-14
2022-06-30,Metro,4082,3909,173,3695,214,778,666,112,632,34,Metro,2022-07-14
2022-06-30,Northeast,767,557,210,514,43,99,65,34,62,3,Greater MN,2022-07-14
2022-06-30,Northwest,258,141,117,136,5,24,16,8,16,0,Greater MN,2022-07-14
2022-06-30,South Central,323,216,107,204,12,22,13,9,12,1,Greater MN,2022-07-14
2022-06-30,Southeast,1284,1096,188,1065,31,253,171,82,165,6,Greater MN,2022-07-14
2022-06-30,Southwest,320,141,179,131,10,9,2,7,2,0,Greater MN,2022-07-14
2022-06-30,State,7845,6745,1100,6390,355,1293,1012,281,966,46,State,2022-07-14
2022-06-30,West Central,154,86,68,82,4,10,3,7,3,0,Greater MN,2022-07-14
2021-07-01,Central,794,619,175,615,4,108,67,41,65,2,Greater MN,2022-07-14
2021-07-01,Metro,4003,3821,182,3761,60,823,697,126,681,16,Metro,2022-07-14
2021-07-01,Northeast,964,557,407,548,9,114,85,29,84,1,Greater MN,2022-07-14
2021-07-01,Northwest,335,173,162,172,1,31,14,17,13,1,Greater MN,2022-07-14
2021-07-01,South Central,357,213,144,208,5,23,9,14,8,1,Greater MN,2022-07-14
2021-07-01,Southeast,1270,983,287,979,4,255,185,70,184,1,Greater MN,2022-07-14
2021-07-01,Southwest,379,128,251,128,0,12,5,7,5,0,Greater MN,2022-07-14
2021-07-01,State,8310,6600,1710,6516,84,1386,1069,317,1047,22,State,2022-07-14
2021-07-01,West Central,208,106,102,105,1,20,7,13,7,0,Greater MN,2022-07-14
2022-07-01,Central,655,594,61,562,32,94,68,26,66,2,Greater MN,2022-07-14
2022-07-01,Metro,4025,3887,138,3674,213,769,674,95,645,29,Metro,2022-07-14
2022-07-01,Northeast,744,515,229,476,39,99,73,26,69,4,Greater MN,2022-07-14
2022-07-01,Northwest,256,137,119,133,4,24,16,8,15,1,Greater MN,2022-07-14
2022-07-01,South Central,322,202,120,188,14,22,13,9,12,1,Greater MN,2022-07-14
2022-07-01,Southeast,1280,1084,196,1053,31,249,176,73,168,8,Greater MN,2022-07-14
2022-07-01,Southwest,314,128,186,121,7,9,0,9,0,0,Greater MN,2022-07-14
2022-07-01,State,7750,6639,1111,6295,344,1277,1023,254,978,45,State,2022-07-14
2022-07-01,West Central,154,92,62,88,4,11,3,8,3,0,Greater MN,2022-07-14
2021-07-02,Central,796,620,176,616,4,116,71,45,69,2,Greater MN,2022-07-14
2021-07-02,Metro,3866,3625,241,3574,51,807,661,146,644,17,Metro,2022-07-14
2021-07-02,Northeast,976,541,435,534,7,114,84,30,82,2,Greater MN,2022-07-14
2021-07-02,Northwest,335,178,157,178,0,31,16,15,15,1,Greater MN,2022-07-14
2021-07-02,South Central,353,209,144,205,4,23,9,14,8,1,Greater MN,2022-07-14
2021-07-02,Southeast,1265,967,298,964,3,252,186,66,185,1,Greater MN,2022-07-14
2021-07-02,Southwest,367,133,234,132,1,12,2,10,2,0,Greater MN,2022-07-14
2021-07-02,State,8166,6377,1789,6307,70,1375,1038,337,1014,24,State,2022-07-14
2021-07-02,West Central,208,104,104,104,0,20,9,11,9,0,Greater MN,2022-07-14
2022-07-02,Central,652,598,54,567,31,91,66,25,65,1,Greater MN,2022-07-14
2022-07-02,Metro,3966,3802,164,3601,201,752,652,100,622,30,Metro,2022-07-14
2022-07-02,Northeast,729,482,247,443,39,99,68,31,66,2,Greater MN,2022-07-14
2022-07-02,Northwest,249,132,117,128,4,24,15,9,14,1,Greater MN,2022-07-14
2022-07-02,South Central,297,184,113,172,12,22,13,9,12,1,Greater MN,2022-07-14
2022-07-02,Southeast,1269,1058,211,1027,31,248,180,68,174,6,Greater MN,2022-07-14
2022-07-02,Southwest,314,106,208,103,3,9,0,9,0,0,Greater MN,2022-07-14
2022-07-02,State,7636,6465,1171,6140,325,1254,998,256,957,41,State,2022-07-14
2022-07-02,West Central,160,103,57,99,4,9,4,5,4,0,Greater MN,2022-07-14
2021-07-03,Central,782,599,183,597,2,110,73,37,71,2,Greater MN,2022-07-14
2021-07-03,Metro,3803,3514,289,3467,47,816,664,152,646,18,Metro,2022-07-14
2021-07-03,Northeast,971,516,455,508,8,114,82,32,81,1,Greater MN,2022-07-14
2021-07-03,Northwest,334,162,172,161,1,31,12,19,12,0,Greater MN,2022-07-14
2021-07-03,South Central,348,194,154,188,6,24,11,13,10,1,Greater MN,2022-07-14
2021-07-03,Southeast,1269,974,295,970,4,258,179,79,178,1,Greater MN,2022-07-14
2021-07-03,Southwest,361,106,255,105,1,12,2,10,2,0,Greater MN,2022-07-14
2021-07-03,State,8076,6147,1929,6078,69,1385,1028,357,1005,23,State,2022-07-14
2021-07-03,West Central,208,82,126,82,0,20,5,15,5,0,Greater MN,2022-07-14
2022-07-03,Central,611,555,56,529,26,92,66,26,64,2,Greater MN,2022-07-14
2022-07-03,Metro,3824,3643,181,3426,217,752,645,107,618,27,Metro,2022-07-14
2022-07-03,Northeast,726,493,233,457,36,99,68,31,65,3,Greater MN,2022-07-14
2022-07-03,Northwest,254,130,124,125,5,24,14,10,13,1,Greater MN,2022-07-14
2022-07-03,South Central,299,165,134,155,10,22,12,10,11,1,Greater MN,2022-07-14
2022-07-03,Southeast,1258,984,274,955,29,247,165,82,163,2,Greater MN,2022-07-14
2022-07-03,Southwest,309,99,210,97,2,9,0,9,0,0,Greater MN,2022-07-14
2022-07-03,State,7437,6161,1276,5830,331,1254,974,280,938,36,State,2022-07-14
2022-07-03,West Central,156,92,64,86,6,9,4,5,4,0,Greater MN,2022-07-14
2021-07-04,Central,762,584,178,580,4,104,67,37,64,3,Greater MN,2022-07-14
2021-07-04,Metro,3699,3353,346,3300,53,800,633,167,618,15,Metro,2022-07-14
2021-07-04,Northeast,974,496,478,489,7,114,79,35,78,1,Greater MN,2022-07-14
2021-07-04,Northwest,334,148,186,147,1,31,9,22,9,0,Greater MN,2022-07-14
2021-07-04,South Central,348,185,163,177,8,24,9,15,9,0,Greater MN,2022-07-14
2021-07-04,Southeast,1273,890,383,887,3,257,153,104,152,1,Greater MN,2022-07-14
2021-07-04,Southwest,363,111,252,111,0,13,3,10,2,1,Greater MN,2022-07-14
2021-07-04,State,7961,5845,2116,5768,77,1363,959,404,938,21,State,2022-07-14
2021-07-04,West Central,208,78,130,77,1,20,6,14,6,0,Greater MN,2022-07-14
2022-07-04,Central,592,537,55,512,25,92,60,32,58,2,Greater MN,2022-07-14
2022-07-04,Metro,3845,3609,236,3406,203,759,650,109,618,32,Metro,2022-07-14
2022-07-04,Northeast,728,487,241,449,38,99,77,22,74,3,Greater MN,2022-07-14
2022-07-04,Northwest,250,127,123,124,3,28,20,8,19,1,Greater MN,2022-07-14
2022-07-04,South Central,300,181,119,169,12,22,13,9,12,1,Greater MN,2022-07-14
2022-07-04,Southeast,1263,961,302,931,30,248,151,97,147,4,Greater MN,2022-07-14
2022-07-04,Southwest,318,106,212,105,1,9,1,8,1,0,Greater MN,2022-07-14
2022-07-04,State,7449,6104,1345,5787,317,1265,975,290,932,43,State,2022-07-14
2022-07-04,West Central,153,96,57,91,5,8,3,5,3,0,Greater MN,2022-07-14
2021-07-05,Central,753,577,176,573,4,99,60,39,59,1,Greater MN,2022-07-14
2021-07-05,Metro,3619,3298,321,3243,55,791,635,156,615,20,Metro,2022-07-14
2021-07-05,Northeast,973,506,467,499,7,114,78,36,77,1,Greater MN,2022-07-14
2021-07-05,Northwest,334,162,172,160,2,31,9,22,9,0,Greater MN,2022-07-14
2021-07-05,South Central,348,183,165,178,5,24,10,14,10,0,Greater MN,2022-07-14
2021-07-05,Southeast,1284,870,414,865,5,259,140,119,139,1,Greater MN,2022-07-14
2021-07-05,Southwest,367,113,254,113,0,11,0,11,0,0,Greater MN,2022-07-14
2021-07-05,State,7886,5789,2097,5708,81,1349,939,410,916,23,State,2022-07-14
2021-07-05,West Central,208,80,128,77,3,20,7,13,7,0,Greater MN,2022-07-14
2022-07-05,Central,619,548,71,519,29,92,63,29,62,1,Greater MN,2022-07-14
2022-07-05,Metro,3855,3647,208,3425,222,752,661,91,628,33,Metro,2022-07-14
2022-07-05,Northeast,724,494,230,457,37,100,77,23,73,4,Greater MN,2022-07-14
2022-07-05,Northwest,254,142,112,138,4,24,14,10,11,3,Greater MN,2022-07-14
2022-07-05,South Central,306,191,115,177,14,22,12,10,11,1,Greater MN,2022-07-14
2022-07-05,Southeast,1265,946,319,918,28,245,137,108,134,3,Greater MN,2022-07-14
2022-07-05,Southwest,314,113,201,109,4,11,1,10,1,0,Greater MN,2022-07-14
2022-07-05,State,7487,6166,1321,5826,340,1255,966,289,921,45,State,2022-07-14
2022-07-05,West Central,150,85,65,83,2,9,1,8,1,0,Greater MN,2022-07-14
2021-07-06,Central,774,592,182,589,3,105,65,40,64,1,Greater MN,2022-07-14
2021-07-06,Metro,3701,3446,255,3392,54,810,645,165,624,21,Metro,2022-07-14
2021-07-06,Northeast,971,520,451,516,4,114,74,40,73,1,Greater MN,2022-07-14
2021-07-06,Northwest,334,158,176,156,2,31,12,19,12,0,Greater MN,2022-07-14
2021-07-06,South Central,348,198,150,193,5,24,9,15,9,0,Greater MN,2022-07-14
2021-07-06,Southeast,1273,893,380,889,4,256,135,121,134,1,Greater MN,2022-07-14
2021-07-06,Southwest,375,120,255,120,0,12,1,11,1,0,Greater MN,2022-07-14
2021-07-06,State,8000,6027,1973,5953,74,1372,951,421,927,24,State,2022-07-14
2021-07-06,West Central,224,100,124,98,2,20,10,10,10,0,Greater MN,2022-07-14
2022-07-06,Central,688,632,56,599,33,94,62,32,62,0,Greater MN,2022-07-14
2022-07-06,Metro,4188,4017,171,3788,229,771,678,93,639,39,Metro,2022-07-14
2022-07-06,Northeast,765,512,253,478,34,108,78,30,72,6,Greater MN,2022-07-14
2022-07-06,Northwest,273,168,105,165,3,26,20,6,16,4,Greater MN,2022-07-14
2022-07-06,South Central,318,205,113,184,21,22,11,11,10,1,Greater MN,2022-07-14
2022-07-06,Southeast,1285,991,294,962,29,245,160,85,154,6,Greater MN,2022-07-14
2022-07-06,Southwest,330,133,197,128,5,11,1,10,1,0,Greater MN,2022-07-14
2022-07-06,State,8029,6771,1258,6415,356,1288,1014,274,958,56,State,2022-07-14
2022-07-06,West Central,182,113,69,111,2,11,4,7,4,0,Greater MN,2022-07-14
2021-07-07,Central,819,657,162,654,3,110,78,32,78,0,Greater MN,2022-07-14
2021-07-07,Metro,4121,3834,287,3783,51,837,685,152,664,21,Metro,2022-07-14
2021-07-07,Northeast,971,537,434,534,3,114,81,33,80,1,Greater MN,2022-07-14
2021-07-07,Northwest,350,203,147,200,3,31,11,20,11,0,Greater MN,2022-07-14
2021-07-07,South Central,349,195,154,191,4,24,11,13,11,0,Greater MN,2022-07-14
2021-07-07,Southeast,1284,965,319,960,5,255,156,99,155,1,Greater MN,2022-07-14
2021-07-07,Southwest,391,131,260,131,0,11,4,7,4,0,Greater MN,2022-07-14
2021-07-07,State,8525,6644,1881,6574,70,1402,1034,368,1011,23,State,2022-07-14
2021-07-07,West Central,240,122,118,121,1,20,8,12,8,0,Greater MN,2022-07-14
2022-07-07,Central,659,606,53,579,27,98,70,28,68,2,Greater MN,2022-07-14
2022-07-07,Metro,4078,3956,122,3718,238,777,675,102,642,33,Metro,2022-07-14
2022-07-07,Northeast,768,524,244,493,31,106,74,32,70,4,Greater MN,2022-07-14
2022-07-07,Northwest,251,151,100,146,5,27,20,7,17,3,Greater MN,2022-07-14
2022-07-07,South Central,318,203,115,192,11,22,11,11,10,1,Greater MN,2022-07-14
2022-07-07,Southeast,1258,1047,211,1006,41,247,170,77,165,5,Greater MN,2022-07-14
2022-07-07,Southwest,317,125,192,122,3,10,1,9,1,0,Greater MN,2022-07-14
2022-07-07,State,7800,6699,1101,6341,358,1296,1022,274,974,48,State,2022-07-14
2022-07-07,West Central,151,87,64,85,2,9,1,8,1,0,Greater MN,2022-07-14
2021-07-08,Central,812,676,136,673,3,112,80,32,80,0,Greater MN,2022-07-14
2021-07-08,Metro,3981,3825,156,3762,63,827,690,137,667,23,Metro,2022-07-14
2021-07-08,Northeast,969,552,417,547,5,114,78,36,78,0,Greater MN,2022-07-14
2021-07-08,Northwest,334,181,153,178,3,31,10,21,10,0,Greater MN,2022-07-14
2021-07-08,South Central,352,215,137,210,5,24,11,13,11,0,Greater MN,2022-07-14
2021-07-08,Southeast,1272,1012,260,1008,4,257,161,96,160,1,Greater MN,2022-07-14
2021-07-08,Southwest,366,120,246,120,0,12,3,9,3,0,Greater MN,2022-07-14
2021-07-08,State,8294,6687,1607,6603,84,1397,1046,351,1022,24,State,2022-07-14
2021-07-08,West Central,208,106,102,105,1,20,13,7,13,0,Greater MN,2022-07-14
2022-07-08,Central,644,592,52,567,25,103,76,27,75,1,Greater MN,2022-07-14
2022-07-08,Metro,4089,3991,98,3749,242,768,652,116,621,31,Metro,2022-07-14
2022-07-08,Northeast,730,528,202,499,29,108,75,33,71,4,Greater MN,2022-07-14
2022-07-08,Northwest,248,150,98,145,5,24,18,6,16,2,Greater MN,2022-07-14
2022-07-08,South Central,310,204,106,188,16,22,9,13,9,0,Greater MN,2022-07-14
2022-07-08,Southeast,1259,1077,182,1035,42,247,178,69,172,6,Greater MN,2022-07-14
2022-07-08,Southwest,320,138,182,135,3,11,1,10,1,0,Greater MN,2022-07-14
2022-07-08,State,7750,6757,993,6394,363,1294,1013,281,969,44,State,2022-07-14
2022-07-08,West Central,150,77,73,76,1,11,4,7,4,0,Greater MN,2022-07-14
2021-07-09,Central,798,642,156,637,5,109,74,35,74,0,Greater MN,2022-07-14
2021-07-09,Metro,4023,3824,199,3766,58,807,660,147,639,21,Metro,2022-07-14
2021-07-09,Northeast,976,548,428,544,4,114,82,32,82,0,Greater MN,2022-07-14
2021-07-09,Northwest,334,170,164,168,2,31,14,17,13,1,Greater MN,2022-07-14
2021-07-09,South Central,353,210,143,205,5,24,9,15,9,0,Greater MN,2022-07-14
2021-07-09,Southeast,1264,996,268,992,4,258,176,82,175,1,Greater MN,2022-07-14
2021-07-09,Southwest,372,124,248,124,0,13,2,11,2,0,Greater MN,2022-07-14
2021-07-09,State,8328,6624,1704,6545,79,1376,1027,349,1004,23,State,2022-07-14
2021-07-09,West Central,208,110,98,109,1,20,10,10,10,0,Greater MN,2022-07-14
2022-07-09,Central,641,597,44,575,22,101,78,23,77,1,Greater MN,2022-07-14
2022-07-09,Metro,3953,3796,157,3592,204,753,649,104,622,27,Metro,2022-07-14
2022-07-09,Northeast,747,511,236,484,27,110,77,33,74,3,Greater MN,2022-07-14
2022-07-09,Northwest,250,120,130,116,4,22,16,6,15,1,Greater MN,2022-07-14
2022-07-09,South Central,290,177,113,164,13,22,11,11,11,0,Greater MN,2022-07-14
2022-07-09,Southeast,1278,1046,232,1013,33,254,176,78,170,6,Greater MN,2022-07-14
2022-07-09,Southwest,305,132,173,131,1,11,0,11,0,0,Greater MN,2022-07-14
2022-07-09,State,7605,6444,1161,6139,305,1282,1015,267,976,39,State,2022-07-14
2022-07-09,West Central,141,65,76,64,1,9,8,1,7,1,Greater MN,2022-07-14
2021-07-10,Central,787,620,167,614,6,114,76,38,76,0,Greater MN,2022-07-14
2021-07-10,Metro,3853,3640,213,3592,48,808,656,152,630,26,Metro,2022-07-14
2021-07-10,Northeast,976,501,475,496,5,114,85,29,85,0,Greater MN,2022-07-14
2021-07-10,Northwest,334,159,175,157,2,31,7,24,7,0,Greater MN,2022-07-14
2021-07-10,South Central,357,192,165,188,4,24,10,14,10,0,Greater MN,2022-07-14
2021-07-10,Southeast,1276,997,279,989,8,257,175,82,175,0,Greater MN,2022-07-14
2021-07-10,Southwest,378,123,255,123,0,12,3,9,3,0,Greater MN,2022-07-14
2021-07-10,State,8169,6321,1848,6248,73,1380,1020,360,994,26,State,2022-07-14
2021-07-10,West Central,208,89,119,89,0,20,8,12,8,0,Greater MN,2022-07-14
2022-07-10,Central,635,557,78,531,26,102,81,21,78,3,Greater MN,2022-07-14
2022-07-10,Metro,3910,3747,163,3545,202,745,635,110,607,28,Metro,2022-07-14
2022-07-10,Northeast,757,488,269,465,23,109,76,33,72,4,Greater MN,2022-07-14
2022-07-10,Northwest,250,119,131,115,4,22,18,4,17,1,Greater MN,2022-07-14
2022-07-10,South Central,300,188,112,176,12,22,12,10,11,1,Greater MN,2022-07-14
2022-07-10,Southeast,1274,994,280,956,38,253,154,99,150,4,Greater MN,2022-07-14
2022-07-10,Southwest,321,128,193,126,2,11,0,11,0,0,Greater MN,2022-07-14
2022-07-10,State,7596,6296,1300,5987,309,1275,981,294,939,42,State,2022-07-14
2022-07-10,West Central,149,75,74,73,2,11,5,6,4,1,Greater MN,2022-07-14
2021-07-11,Central,769,611,158,603,8,97,58,39,58,0,Greater MN,2022-07-14
2021-07-11,Metro,3826,3563,263,3511,52,786,635,151,613,22,Metro,2022-07-14
2021-07-11,Northeast,963,499,464,494,5,114,77,37,77,0,Greater MN,2022-07-14
2021-07-11,Northwest,334,156,178,154,2,31,9,22,8,1,Greater MN,2022-07-14
2021-07-11,South Central,362,203,159,198,5,24,10,14,10,0,Greater MN,2022-07-14
2021-07-11,Southeast,1269,939,330,931,8,255,152,103,152,0,Greater MN,2022-07-14
2021-07-11,Southwest,378,128,250,128,0,10,1,9,1,0,Greater MN,2022-07-14
2021-07-11,State,8109,6183,1926,6102,81,1337,950,387,927,23,State,2022-07-14
2021-07-11,West Central,208,84,124,83,1,20,8,12,8,0,Greater MN,2022-07-14
2022-07-11,Central,639,595,44,562,33,93,75,18,73,2,Greater MN,2022-07-14
2022-07-11,Metro,3919,3734,185,3517,217,765,648,117,618,30,Metro,2022-07-14
2022-07-11,Northeast,757,510,247,481,29,109,72,37,68,4,Greater MN,2022-07-14
2022-07-11,Northwest,250,126,124,122,4,22,12,10,11,1,Greater MN,2022-07-14
2022-07-11,South Central,298,187,111,175,12,22,10,12,9,1,Greater MN,2022-07-14
2022-07-11,Southeast,1268,981,287,945,36,249,151,98,147,4,Greater MN,2022-07-14
2022-07-11,Southwest,300,110,190,108,2,9,1,8,1,0,Greater MN,2022-07-14
2022-07-11,State,7576,6334,1242,5999,335,1279,973,306,930,43,State,2022-07-14
2022-07-11,West Central,145,91,54,89,2,10,4,6,3,1,Greater MN,2022-07-14
2021-07-12,Central,788,649,139,642,7,95,55,40,54,1,Greater MN,2022-07-14
2021-07-12,Metro,3806,3499,307,3445,54,792,662,130,643,19,Metro,2022-07-14
2021-07-12,Northeast,963,528,435,525,3,116,75,41,75,0,Greater MN,2022-07-14
2021-07-12,Northwest,334,167,167,164,3,31,13,18,11,2,Greater MN,2022-07-14
2021-07-12,South Central,353,201,152,196,5,24,8,16,8,0,Greater MN,2022-07-14
2021-07-12,Southeast,1249,911,338,904,7,257,148,109,147,1,Greater MN,2022-07-14
2021-07-12,Southwest,371,130,241,130,0,12,5,7,5,0,Greater MN,2022-07-14
2021-07-12,State,8072,6179,1893,6098,81,1347,975,372,952,23,State,2022-07-14
2021-07-12,West Central,208,94,114,92,2,20,9,11,9,0,Greater MN,2022-07-14
2022-07-12,Central,697,652,45,630,22,99,71,28,67,4,Greater MN,2022-07-14
2022-07-12,Metro,4057,3912,145,3699,213,744,652,92,622,30,Metro,2022-07-14
2022-07-12,Northeast,753,537,216,504,33,109,72,37,67,5,Greater MN,2022-07-14
2022-07-12,Northwest,258,143,115,137,6,22,13,9,13,0,Greater MN,2022-07-14
2022-07-12,South Central,308,215,93,198,17,22,11,11,11,0,Greater MN,2022-07-14
2022-07-12,Southeast,1270,1043,227,1008,35,248,162,86,158,4,Greater MN,2022-07-14
2022-07-12,Southwest,316,127,189,121,6,11,1,10,1,0,Greater MN,2022-07-14
2022-07-12,State,7807,6738,1069,6405,333,1265,986,279,942,44,State,2022-07-14
2022-07-12,West Central,148,109,39,108,1,10,4,6,3,1,Greater MN,2022-07-14
2021-07-13,Central,818,692,126,685,7,105,69,36,68,1,Greater MN,2022-07-14
2021-07-13,Metro,4007,3747,260,3694,53,804,683,121,665,18,Metro,2022-07-14
2021-07-13,Northeast,964,537,427,533,4,118,78,40,78,0,Greater MN,2022-07-14
2021-07-13,Northwest,334,163,171,160,3,31,17,14,15,2,Greater MN,2022-07-14
2021-07-13,South Central,355,224,131,221,3,24,9,15,9,0,Greater MN,2022-07-14
2021-07-13,Southeast,1255,977,278,971,6,258,162,96,161,1,Greater MN,2022-07-14
2021-07-13,Southwest,382,153,229,153,0,12,5,7,5,0,Greater MN,2022-07-14
2021-07-13,State,8323,6597,1726,6521,76,1372,1031,341,1009,22,State,2022-07-14
2021-07-13,West Central,208,104,104,104,0,20,8,12,8,0,Greater MN,2022-07-14
2022-07-13,Central,151,125,26,118,7,24,6,18,6,0,Greater MN,2022-07-14
2022-07-13,Metro,1491,1384,107,1312,72,382,301,81,288,13,Metro,2022-07-14
2022-07-13,Northeast,644,473,171,442,31,99,64,35,60,4,Greater MN,2022-07-14
2022-07-13,Northwest,256,153,103,145,8,18,11,7,11,0,Greater MN,2022-07-14
2022-07-13,South Central,246,188,58,176,12,22,11,11,11,0,Greater MN,2022-07-14
2022-07-13,Southeast,1245,1054,191,1027,27,251,172,79,167,5,Greater MN,2022-07-14
2022-07-13,Southwest,175,62,113,59,3,9,1,8,1,0,Greater MN,2022-07-14
2022-07-13,State,4342,3520,822,3358,162,810,566,244,544,22,State,2022-07-14
2022-07-13,West Central,134,81,53,79,2,5,0,5,0,0,Greater MN,2022-07-14
2021-07-14,Central,862,742,120,732,10,107,68,39,68,0,Greater MN,2022-07-14
2021-07-14,Metro,4221,4025,196,3978,47,808,678,130,662,16,Metro,2022-07-14
2021-07-14,Northeast,961,534,427,531,3,119,77,42,77,0,Greater MN,2022-07-14
2021-07-14,Northwest,350,164,186,162,2,31,12,19,10,2,Greater MN,2022-07-14
2021-07-14,South Central,356,233,123,231,2,24,8,16,8,0,Greater MN,2022-07-14
2021-07-14,Southeast,1288,1059,229,1052,7,257,175,82,174,1,Greater MN,2022-07-14
2021-07-14,Southwest,389,135,254,135,0,11,1,10,1,0,Greater MN,2022-07-14
2021-07-14,State,8667,7020,1647,6949,71,1377,1028,349,1009,19,State,2022-07-14
2021-07-14,West Central,240,128,112,128,0,20,9,11,9,0,Greater MN,2022-07-14
2021-07-15,Central,791,662,129,652,10,109,69,40,68,1,Greater MN,2022-07-14
2021-07-15,Metro,3983,3869,114,3822,47,809,689,120,673,16,Metro,2022-07-14
2021-07-15,Northeast,965,531,434,528,3,118,73,45,73,0,Greater MN,2022-07-14
2021-07-15,Northwest,334,144,190,143,1,31,14,17,13,1,Greater MN,2022-07-14
2021-07-15,South Central,360,213,147,209,4,24,10,14,10,0,Greater MN,2022-07-14
2021-07-15,Southeast,1279,1058,221,1052,6,258,171,87,170,1,Greater MN,2022-07-14
2021-07-15,Southwest,367,124,243,124,0,12,3,9,3,0,Greater MN,2022-07-14
2021-07-15,State,8287,6706,1581,6634,72,1381,1038,343,1019,19,State,2022-07-14
2021-07-15,West Central,208,105,103,104,1,20,9,11,9,0,Greater MN,2022-07-14
2021-07-16,Central,788,642,146,629,13,102,66,36,66,0,Greater MN,2022-07-14
2021-07-16,Metro,3964,3818,146,3767,51,823,679,144,662,17,Metro,2022-07-14
2021-07-16,Northeast,954,531,423,526,5,119,69,50,69,0,Greater MN,2022-07-14
2021-07-16,Northwest,334,160,174,159,1,31,11,20,9,2,Greater MN,2022-07-14
2021-07-16,South Central,358,218,140,214,4,24,11,13,11,0,Greater MN,2022-07-14
2021-07-16,Southeast,1280,1080,200,1074,6,257,179,78,178,1,Greater MN,2022-07-14
2021-07-16,Southwest,364,101,263,101,0,12,2,10,2,0,Greater MN,2022-07-14
2021-07-16,State,8250,6641,1609,6560,81,1388,1025,363,1005,20,State,2022-07-14
2021-07-16,West Central,208,91,117,90,1,20,8,12,8,0,Greater MN,2022-07-14
2021-07-17,Central,800,643,157,629,14,109,71,38,70,1,Greater MN,2022-07-14
2021-07-17,Metro,3962,3797,165,3747,50,808,666,142,647,19,Metro,2022-07-14
2021-07-17,Northeast,960,526,434,519,7,120,75,45,75,0,Greater MN,2022-07-14
2021-07-17,Northwest,334,140,194,139,1,31,13,18,10,3,Greater MN,2022-07-14
2021-07-17,South Central,355,201,154,199,2,24,9,15,9,0,Greater MN,2022-07-14
2021-07-17,Southeast,1283,1050,233,1049,1,257,175,82,175,0,Greater MN,2022-07-14
2021-07-17,Southwest,366,102,264,102,0,12,2,10,2,0,Greater MN,2022-07-14
2021-07-17,State,8268,6549,1719,6473,76,1381,1019,362,996,23,State,2022-07-14
2021-07-17,West Central,208,90,118,89,1,20,8,12,8,0,Greater MN,2022-07-14
2021-07-18,Central,799,617,182,604,13,111,70,41,68,2,Greater MN,2022-07-14
2021-07-18,Metro,3866,3618,248,3573,45,807,661,146,643,18,Metro,2022-07-14
2021-07-18,Northeast,961,500,461,495,5,118,74,44,74,0,Greater MN,2022-07-14
2021-07-18,Northwest,334,140,194,139,1,31,9,22,7,2,Greater MN,2022-07-14
2021-07-18,South Central,351,197,154,193,4,23,9,14,9,0,Greater MN,2022-07-14
2021-07-18,Southeast,1273,967,306,957,10,257,165,92,164,1,Greater MN,2022-07-14
2021-07-18,Southwest,367,107,260,107,0,12,4,8,4,0,Greater MN,2022-07-14
2021-07-18,State,8159,6235,1924,6155,80,1379,996,383,973,23,State,2022-07-14
2021-07-18,West Central,208,89,119,87,2,20,4,16,4,0,Greater MN,2022-07-14
2021-07-19,Central,783,610,173,594,16,116,73,43,72,1,Greater MN,2022-07-14
2021-07-19,Metro,3814,3571,243,3523,48,819,674,145,654,20,Metro,2022-07-14
2021-07-19,Northeast,959,513,446,508,5,120,72,48,71,1,Greater MN,2022-07-14
2021-07-19,Northwest,334,142,192,141,1,31,11,20,9,2,Greater MN,2022-07-14
2021-07-19,South Central,351,191,160,188,3,24,8,16,8,0,Greater MN,2022-07-14
2021-07-19,Southeast,1274,960,314,949,11,256,156,100,155,1,Greater MN,2022-07-14
2021-07-19,Southwest,367,95,272,95,0,12,3,9,3,0,Greater MN,2022-07-14
2021-07-19,State,8090,6176,1914,6092,84,1398,1001,397,976,25,State,2022-07-14
2021-07-19,West Central,208,94,114,94,0,20,4,16,4,0,Greater MN,2022-07-14
2021-07-20,Central,754,598,156,585,13,115,76,39,73,3,Greater MN,2022-07-14
2021-07-20,Metro,3965,3792,173,3740,52,840,703,137,681,22,Metro,2022-07-14
2021-07-20,Northeast,969,522,447,514,8,117,81,36,81,0,Greater MN,2022-07-14
2021-07-20,Northwest,334,161,173,159,2,31,11,20,10,1,Greater MN,2022-07-14
2021-07-20,South Central,350,210,140,207,3,24,9,15,9,0,Greater MN,2022-07-14
2021-07-20,Southeast,1282,1018,264,1008,10,256,168,88,166,2,Greater MN,2022-07-14
2021-07-20,Southwest,367,105,262,105,0,12,3,9,3,0,Greater MN,2022-07-14
2021-07-20,State,8229,6521,1708,6433,88,1415,1060,355,1032,28,State,2022-07-14
2021-07-20,West Central,208,115,93,115,0,20,9,11,9,0,Greater MN,2022-07-14
2021-07-21,Central,806,658,148,649,9,116,77,39,74,3,Greater MN,2022-07-14
2021-07-21,Metro,4230,3990,240,3937,53,830,699,131,679,20,Metro,2022-07-14
2021-07-21,Northeast,995,553,442,546,7,119,82,37,81,1,Greater MN,2022-07-14
2021-07-21,Northwest,350,186,164,185,1,31,15,16,14,1,Greater MN,2022-07-14
2021-07-21,South Central,364,214,150,213,1,24,9,15,8,1,Greater MN,2022-07-14
2021-07-21,Southeast,1298,1053,245,1043,10,256,183,73,182,1,Greater MN,2022-07-14
2021-07-21,Southwest,382,124,258,124,0,12,1,11,1,0,Greater MN,2022-07-14
2021-07-21,State,8665,6914,1751,6833,81,1408,1074,334,1047,27,State,2022-07-14
2021-07-21,West Central,240,136,104,136,0,20,8,12,8,0,Greater MN,2022-07-14
2021-07-22,Central,778,628,150,617,11,118,80,38,76,4,Greater MN,2022-07-14
2021-07-22,Metro,4048,3874,174,3811,63,833,702,131,680,22,Metro,2022-07-14
2021-07-22,Northeast,995,543,452,540,3,119,87,32,87,0,Greater MN,2022-07-14
2021-07-22,Northwest,334,166,168,165,1,31,12,19,10,2,Greater MN,2022-07-14
2021-07-22,South Central,360,215,145,214,1,24,10,14,7,3,Greater MN,2022-07-14
2021-07-22,Southeast,1276,1043,233,1033,10,257,180,77,177,3,Greater MN,2022-07-14
2021-07-22,Southwest,376,123,253,123,0,11,2,9,2,0,Greater MN,2022-07-14
2021-07-22,State,8375,6689,1686,6600,89,1413,1081,332,1047,34,State,2022-07-14
2021-07-22,West Central,208,97,111,97,0,20,8,12,8,0,Greater MN,2022-07-14
2021-07-23,Central,793,620,173,607,13,115,78,37,73,5,Greater MN,2022-07-14
2021-07-23,Metro,4032,3793,239,3712,81,824,696,128,671,25,Metro,2022-07-14
2021-07-23,Northeast,1000,545,455,543,2,119,81,38,81,0,Greater MN,2022-07-14
2021-07-23,Northwest,334,167,167,165,2,31,12,19,10,2,Greater MN,2022-07-14
2021-07-23,South Central,358,203,155,202,1,24,11,13,8,3,Greater MN,2022-07-14
2021-07-23,Southeast,1277,1045,232,1032,13,255,177,78,174,3,Greater MN,2022-07-14
2021-07-23,Southwest,367,124,243,124,0,10,1,9,0,1,Greater MN,2022-07-14
2021-07-23,State,8369,6612,1757,6498,114,1398,1059,339,1020,39,State,2022-07-14
2021-07-23,West Central,208,115,93,113,2,20,3,17,3,0,Greater MN,2022-07-14
2021-07-24,Central,779,580,199,565,15,115,73,42,67,6,Greater MN,2022-07-14
2021-07-24,Metro,3969,3646,323,3566,80,817,675,142,651,24,Metro,2022-07-14
2021-07-24,Northeast,943,503,440,500,3,120,84,36,83,1,Greater MN,2022-07-14
2021-07-24,Northwest,334,147,187,145,2,31,12,19,10,2,Greater MN,2022-07-14
2021-07-24,South Central,354,195,159,194,1,24,9,15,6,3,Greater MN,2022-07-14
2021-07-24,Southeast,1279,1016,263,1003,13,256,167,89,165,2,Greater MN,2022-07-14
2021-07-24,Southwest,362,104,258,103,1,10,2,8,2,0,Greater MN,2022-07-14
2021-07-24,State,8228,6284,1944,6167,117,1393,1027,366,989,38,State,2022-07-14
2021-07-24,West Central,208,93,115,91,2,20,5,15,5,0,Greater MN,2022-07-14
2021-07-25,Central,779,580,199,567,13,107,69,38,61,8,Greater MN,2022-07-14
2021-07-25,Metro,3887,3593,294,3510,83,807,668,139,641,27,Metro,2022-07-14
2021-07-25,Northeast,943,498,445,496,2,119,80,39,79,1,Greater MN,2022-07-14
2021-07-25,Northwest,334,145,189,143,2,31,9,22,7,2,Greater MN,2022-07-14
2021-07-25,South Central,354,187,167,182,5,24,9,15,6,3,Greater MN,2022-07-14
2021-07-25,Southeast,1270,961,309,947,14,256,156,100,153,3,Greater MN,2022-07-14
2021-07-25,Southwest,355,100,255,98,2,11,4,7,4,0,Greater MN,2022-07-14
2021-07-25,State,8130,6147,1983,6024,123,1375,1000,375,956,44,State,2022-07-14
2021-07-25,West Central,208,83,125,81,2,20,5,15,5,0,Greater MN,2022-07-14
2021-07-26,Central,764,587,177,576,11,112,80,32,69,11,Greater MN,2022-07-14
2021-07-26,Metro,3773,3458,315,3384,74,812,678,134,646,32,Metro,2022-07-14
2021-07-26,Northeast,948,492,456,490,2,118,75,43,74,1,Greater MN,2022-07-14
2021-07-26,Northwest,334,163,171,162,1,31,11,20,9,2,Greater MN,2022-07-14
2021-07-26,South Central,357,209,148,200,9,24,10,14,8,2,Greater MN,2022-07-14
2021-07-26,Southeast,1264,950,314,932,18,254,154,100,150,4,Greater MN,2022-07-14
2021-07-26,Southwest,366,103,263,102,1,12,5,7,4,1,Greater MN,2022-07-14
2021-07-26,State,8014,6050,1964,5932,118,1383,1019,364,966,53,State,2022-07-14
2021-07-26,West Central,208,88,120,86,2,20,6,14,6,0,Greater MN,2022-07-14
2021-07-27,Central,779,646,133,632,14,114,74,40,67,7,Greater MN,2022-07-14
2021-07-27,Metro,3942,3696,246,3600,96,823,703,120,667,36,Metro,2022-07-14
2021-07-27,Northeast,952,520,432,518,2,117,81,36,81,0,Greater MN,2022-07-14
2021-07-27,Northwest,334,154,180,153,1,31,13,18,10,3,Greater MN,2022-07-14
2021-07-27,South Central,359,225,134,213,12,24,10,14,8,2,Greater MN,2022-07-14
2021-07-27,Southeast,1279,1038,241,1021,17,257,181,76,174,7,Greater MN,2022-07-14
2021-07-27,Southwest,382,131,251,128,3,11,2,9,1,1,Greater MN,2022-07-14
2021-07-27,State,8235,6528,1707,6382,146,1397,1066,331,1010,56,State,2022-07-14
2021-07-27,West Central,208,118,90,117,1,20,2,18,2,0,Greater MN,2022-07-14
2021-07-28,Central,827,688,139,673,15,117,79,38,72,7,Greater MN,2022-07-14
2021-07-28,Metro,4202,3958,244,3858,100,840,730,110,693,37,Metro,2022-07-14
2021-07-28,Northeast,956,526,430,521,5,119,92,27,91,1,Greater MN,2022-07-14
2021-07-28,Northwest,350,174,176,171,3,31,12,19,10,2,Greater MN,2022-07-14
2021-07-28,South Central,358,220,138,211,9,24,9,15,7,2,Greater MN,2022-07-14
2021-07-28,Southeast,1293,1090,203,1076,14,259,188,71,180,8,Greater MN,2022-07-14
2021-07-28,Southwest,395,136,259,132,4,11,4,7,4,0,Greater MN,2022-07-14
2021-07-28,State,8621,6932,1689,6781,151,1421,1117,304,1060,57,State,2022-07-14
2021-07-28,West Central,240,140,100,139,1,20,3,17,3,0,Greater MN,2022-07-14
2021-07-29,Central,808,649,159,634,15,122,86,36,77,9,Greater MN,2022-07-14
2021-07-29,Metro,4004,3821,183,3711,110,825,709,116,668,41,Metro,2022-07-14
2021-07-29,Northeast,955,533,422,527,6,117,80,37,79,1,Greater MN,2022-07-14
2021-07-29,Northwest,334,163,171,160,3,31,14,17,11,3,Greater MN,2022-07-14
2021-07-29,South Central,357,224,133,210,14,24,10,14,8,2,Greater MN,2022-07-14
2021-07-29,Southeast,1279,1094,185,1083,11,257,184,73,176,8,Greater MN,2022-07-14
2021-07-29,Southwest,378,137,241,131,6,11,3,8,3,0,Greater MN,2022-07-14
2021-07-29,State,8323,6726,1597,6559,167,1407,1091,316,1027,64,State,2022-07-14
2021-07-29,West Central,208,105,103,103,2,20,5,15,5,0,Greater MN,2022-07-14
2021-07-30,Central,802,643,159,624,19,113,78,35,69,9,Greater MN,2022-07-14
2021-07-30,Metro,4029,3829,200,3724,105,817,709,108,666,43,Metro,2022-07-14
2021-07-30,Northeast,955,513,442,508,5,120,82,38,81,1,Greater MN,2022-07-14
2021-07-30,Northwest,334,172,162,169,3,31,13,18,10,3,Greater MN,2022-07-14
2021-07-30,South Central,357,212,145,199,13,24,10,14,8,2,Greater MN,2022-07-14
2021-07-30,Southeast,1277,1062,215,1049,13,257,189,68,179,10,Greater MN,2022-07-14
2021-07-30,Southwest,371,122,249,118,4,10,0,10,0,0,Greater MN,2022-07-14
2021-07-30,State,8333,6640,1693,6477,163,1392,1086,306,1018,68,State,2022-07-14
2021-07-30,West Central,208,87,121,86,1,20,5,15,5,0,Greater MN,2022-07-14
2021-07-31,Central,759,594,165,574,20,117,79,38,71,8,Greater MN,2022-07-14
2021-07-31,Metro,3952,3751,201,3650,101,806,690,116,645,45,Metro,2022-07-14
2021-07-31,Northeast,935,512,423,503,9,119,82,37,81,1,Greater MN,2022-07-14
2021-07-31,Northwest,334,157,177,152,5,31,12,19,10,2,Greater MN,2022-07-14
2021-07-31,South Central,355,192,163,178,14,24,8,16,7,1,Greater MN,2022-07-14
2021-07-31,Southeast,1277,1029,248,1010,19,253,181,72,171,10,Greater MN,2022-07-14
2021-07-31,Southwest,358,115,243,111,4,10,1,9,1,0,Greater MN,2022-07-14
2021-07-31,State,8178,6438,1740,6264,174,1380,1056,324,989,67,State,2022-07-14
2021-07-31,West Central,208,88,120,86,2,20,3,17,3,0,Greater MN,2022-07-14
2020-08-01,Central,850,530,320,519,11,159,88,71,85,3,Greater MN,2022-07-14
2020-08-01,Metro,4638,3646,992,3566,80,893,730,163,678,52,Metro,2022-07-14
2020-08-01,Northeast,715,295,420,287,8,88,59,29,58,1,Greater MN,2022-07-14
2020-08-01,Northwest,330,123,207,120,3,25,12,13,12,0,Greater MN,2022-07-14
2020-08-01,South Central,569,201,368,188,13,28,8,20,6,2,Greater MN,2022-07-14
2020-08-01,Southeast,1473,937,536,927,10,255,166,89,160,6,Greater MN,2022-07-14
2020-08-01,Southwest,423,119,304,117,2,18,4,14,4,0,Greater MN,2022-07-14
2020-08-01,State,9187,5916,3271,5787,129,1480,1073,407,1009,64,State,2022-07-14
2020-08-01,State,0,0,0,-2,2,0,0,0,0,0,State,2022-07-14
2020-08-01,West Central,189,65,124,65,0,14,6,8,6,0,Greater MN,2022-07-14
2021-08-01,Central,746,577,169,559,18,112,77,35,68,9,Greater MN,2022-07-14
2021-08-01,Metro,3818,3594,224,3481,113,805,685,120,642,43,Metro,2022-07-14
2021-08-01,Northeast,947,500,447,492,8,118,84,34,82,2,Greater MN,2022-07-14
2021-08-01,Northwest,334,148,186,143,5,31,15,16,13,2,Greater MN,2022-07-14
2021-08-01,South Central,357,200,157,185,15,24,8,16,6,2,Greater MN,2022-07-14
2021-08-01,Southeast,1276,961,315,942,19,255,151,104,144,7,Greater MN,2022-07-14
2021-08-01,Southwest,370,115,255,112,3,10,1,9,1,0,Greater MN,2022-07-14
2021-08-01,State,8056,6191,1865,6007,184,1375,1026,349,961,65,State,2022-07-14
2021-08-01,West Central,208,96,112,93,3,20,5,15,5,0,Greater MN,2022-07-14
2020-08-02,Central,869,524,345,518,6,159,86,73,81,5,Greater MN,2022-07-14
2020-08-02,Metro,4577,3549,1028,3452,97,869,700,169,653,47,Metro,2022-07-14
2020-08-02,Northeast,1210,619,591,608,11,129,84,45,82,2,Greater MN,2022-07-14
2020-08-02,Northwest,445,202,243,198,4,52,36,16,36,0,Greater MN,2022-07-14
2020-08-02,South Central,529,192,337,181,11,28,9,19,7,2,Greater MN,2022-07-14
2020-08-02,Southeast,1473,877,596,865,12,255,149,106,144,5,Greater MN,2022-07-14
2020-08-02,Southwest,404,113,291,112,1,18,5,13,5,0,Greater MN,2022-07-14
2020-08-02,State,9660,6115,3545,5972,143,1520,1074,446,1012,62,State,2022-07-14
2020-08-02,West Central,153,39,114,38,1,10,5,5,4,1,Greater MN,2022-07-14
2021-08-02,Central,764,567,197,548,19,110,78,32,67,11,Greater MN,2022-07-14
2021-08-02,Metro,3772,3528,244,3424,104,809,680,129,629,51,Metro,2022-07-14
2021-08-02,Northeast,948,516,432,507,9,118,82,36,80,2,Greater MN,2022-07-14
2021-08-02,Northwest,334,150,184,146,4,31,14,17,12,2,Greater MN,2022-07-14
2021-08-02,South Central,357,213,144,198,15,24,11,13,9,2,Greater MN,2022-07-14
2021-08-02,Southeast,1267,958,309,937,21,255,156,99,149,7,Greater MN,2022-07-14
2021-08-02,Southwest,370,117,253,115,2,9,1,8,1,0,Greater MN,2022-07-14
2021-08-02,State,8020,6149,1871,5973,176,1376,1028,348,953,75,State,2022-07-14
2021-08-02,West Central,208,100,108,98,2,20,6,14,6,0,Greater MN,2022-07-14
2020-08-03,Central,867,496,371,486,10,159,83,76,77,6,Greater MN,2022-07-14
2020-08-03,Metro,4637,3689,948,3548,141,895,691,204,629,62,Metro,2022-07-14
2020-08-03,Northeast,1124,471,653,459,12,114,71,43,68,3,Greater MN,2022-07-14
2020-08-03,Northwest,351,119,232,116,3,25,10,15,10,0,Greater MN,2022-07-14
2020-08-03,South Central,550,210,340,200,10,28,10,18,8,2,Greater MN,2022-07-14
2020-08-03,Southeast,1473,868,605,854,14,255,130,125,125,5,Greater MN,2022-07-14
2020-08-03,Southwest,417,129,288,128,1,17,3,14,3,0,Greater MN,2022-07-14
2020-08-03,State,9630,6049,3581,5857,192,1510,1004,506,925,79,State,2022-07-14
2020-08-03,West Central,211,67,144,66,1,17,6,11,5,1,Greater MN,2022-07-14
2021-08-03,Central,792,601,191,584,17,111,80,31,69,11,Greater MN,2022-07-14
2021-08-03,Metro,4019,3818,201,3706,112,821,706,115,652,54,Metro,2022-07-14
2021-08-03,Northeast,956,512,444,502,10,119,78,41,76,2,Greater MN,2022-07-14
2021-08-03,Northwest,334,163,171,158,5,31,14,17,11,3,Greater MN,2022-07-14
2021-08-03,South Central,367,235,132,218,17,24,11,13,9,2,Greater MN,2022-07-14
2021-08-03,Southeast,1280,997,283,975,22,255,175,80,166,9,Greater MN,2022-07-14
2021-08-03,Southwest,376,125,251,124,1,11,1,10,1,0,Greater MN,2022-07-14
2021-08-03,State,8332,6561,1771,6374,187,1392,1072,320,991,81,State,2022-07-14
2021-08-03,West Central,208,110,98,107,3,20,7,13,7,0,Greater MN,2022-07-14
2020-08-04,Central,875,575,300,566,9,160,93,67,88,5,Greater MN,2022-07-14
2020-08-04,Metro,4679,3848,831,3703,145,910,720,190,646,74,Metro,2022-07-14
2020-08-04,Northeast,1166,600,566,590,10,113,77,36,73,4,Greater MN,2022-07-14
2020-08-04,Northwest,328,133,195,129,4,27,11,16,11,0,Greater MN,2022-07-14
2020-08-04,South Central,531,210,321,201,9,24,7,17,5,2,Greater MN,2022-07-14
2020-08-04,Southeast,1473,944,529,931,13,255,148,107,141,7,Greater MN,2022-07-14
2020-08-04,Southwest,406,134,272,132,2,18,2,16,2,0,Greater MN,2022-07-14
2020-08-04,State,9985,6726,3259,6532,194,1543,1077,466,985,92,State,2022-07-14
2020-08-04,State,338,210,128,210,0,22,15,7,15,0,State,2022-07-14
2020-08-04,West Central,189,72,117,70,2,14,4,10,4,0,Greater MN,2022-07-14
2021-08-04,Central,811,628,183,612,16,114,84,30,75,9,Greater MN,2022-07-14
2021-08-04,Metro,4189,3995,194,3876,119,835,706,129,652,54,Metro,2022-07-14
2021-08-04,Northeast,953,554,399,542,12,120,76,44,75,1,Greater MN,2022-07-14
2021-08-04,Northwest,350,184,166,180,4,31,12,19,8,4,Greater MN,2022-07-14
2021-08-04,South Central,359,201,158,188,13,24,10,14,7,3,Greater MN,2022-07-14
2021-08-04,Southeast,1298,1069,229,1047,22,257,181,76,171,10,Greater MN,2022-07-14
2021-08-04,Southwest,401,129,272,128,1,12,0,12,0,0,Greater MN,2022-07-14
2021-08-04,State,8601,6900,1701,6711,189,1413,1076,337,995,81,State,2022-07-14
2021-08-04,West Central,240,140,100,138,2,20,7,13,7,0,Greater MN,2022-07-14
2020-08-05,Central,908,594,314,583,11,166,91,75,86,5,Greater MN,2022-07-14
2020-08-05,Metro,4832,4029,803,3886,143,907,704,203,632,72,Metro,2022-07-14
2020-08-05,Northeast,1124,509,615,498,11,115,78,37,75,3,Greater MN,2022-07-14
2020-08-05,Northwest,344,144,200,139,5,32,16,16,15,1,Greater MN,2022-07-14
2020-08-05,South Central,542,191,351,184,7,26,8,18,6,2,Greater MN,2022-07-14
2020-08-05,Southeast,1473,915,558,903,12,255,163,92,156,7,Greater MN,2022-07-14
2020-08-05,Southwest,420,125,295,122,3,22,2,20,2,0,Greater MN,2022-07-14
2020-08-05,State,9854,6589,3265,6397,192,1540,1065,475,975,90,State,2022-07-14
2020-08-05,West Central,211,82,129,82,0,17,3,14,3,0,Greater MN,2022-07-14
2021-08-05,Central,795,619,176,602,17,113,83,30,72,11,Greater MN,2022-07-14
2021-08-05,Metro,4027,3371,656,3253,118,844,711,133,662,49,Metro,2022-07-14
2021-08-05,Northeast,958,557,401,547,10,119,87,32,84,3,Greater MN,2022-07-14
2021-08-05,Northwest,334,176,158,173,3,31,9,22,6,3,Greater MN,2022-07-14
2021-08-05,South Central,357,213,144,201,12,24,8,16,5,3,Greater MN,2022-07-14
2021-08-05,Southeast,1274,1047,227,1025,22,258,181,77,170,11,Greater MN,2022-07-14
2021-08-05,Southwest,382,135,247,133,2,15,3,12,3,0,Greater MN,2022-07-14
2021-08-05,State,8335,6218,2117,6031,187,1424,1087,337,1007,80,State,2022-07-14
2021-08-05,West Central,208,100,108,97,3,20,5,15,5,0,Greater MN,2022-07-14
2020-08-06,Central,883,579,304,571,8,162,83,79,76,7,Greater MN,2022-07-14
2020-08-06,Metro,4864,4029,835,3882,147,922,716,206,643,73,Metro,2022-07-14
2020-08-06,Northeast,1124,566,558,554,12,114,76,38,74,2,Greater MN,2022-07-14
2020-08-06,Northwest,336,140,196,137,3,32,13,19,11,2,Greater MN,2022-07-14
2020-08-06,South Central,567,218,349,206,12,26,5,21,3,2,Greater MN,2022-07-14
2020-08-06,Southeast,1473,945,528,932,13,255,176,79,169,7,Greater MN,2022-07-14
2020-08-06,Southwest,426,147,279,145,2,21,2,19,2,0,Greater MN,2022-07-14
2020-08-06,State,9884,6708,3176,6511,197,1549,1075,474,982,93,State,2022-07-14
2020-08-06,West Central,211,84,127,84,0,17,4,13,4,0,Greater MN,2022-07-14
2021-08-06,Central,772,622,150,599,23,109,80,29,71,9,Greater MN,2022-07-14
2021-08-06,Metro,4085,3807,278,3671,136,829,718,111,662,56,Metro,2022-07-14
2021-08-06,Northeast,948,559,389,551,8,120,77,43,73,4,Greater MN,2022-07-14
2021-08-06,Northwest,334,174,160,171,3,31,15,16,12,3,Greater MN,2022-07-14
2021-08-06,South Central,354,223,131,210,13,24,10,14,7,3,Greater MN,2022-07-14
2021-08-06,Southeast,1280,1064,216,1036,28,255,184,71,173,11,Greater MN,2022-07-14
2021-08-06,Southwest,361,119,242,117,2,12,4,8,3,1,Greater MN,2022-07-14
2021-08-06,State,8342,6652,1690,6438,214,1400,1093,307,1006,87,State,2022-07-14
2021-08-06,West Central,208,84,124,83,1,20,5,15,5,0,Greater MN,2022-07-14
2020-08-07,Central,898,581,317,576,5,166,84,82,79,5,Greater MN,2022-07-14
2020-08-07,Metro,4835,4006,829,3849,157,914,701,213,632,69,Metro,2022-07-14
2020-08-07,Northeast,1159,597,562,586,11,114,76,38,74,2,Greater MN,2022-07-14
2020-08-07,Northwest,344,151,193,146,5,32,12,20,11,1,Greater MN,2022-07-14
2020-08-07,South Central,542,213,329,206,7,26,6,20,4,2,Greater MN,2022-07-14
2020-08-07,Southeast,1473,945,528,935,10,251,153,98,146,7,Greater MN,2022-07-14
2020-08-07,Southwest,366,117,249,116,1,17,2,15,2,0,Greater MN,2022-07-14
2020-08-07,State,9821,6687,3134,6491,196,1537,1037,500,951,86,State,2022-07-14
2020-08-07,West Central,204,77,127,77,0,17,3,14,3,0,Greater MN,2022-07-14
2021-08-07,Central,757,582,175,557,25,114,86,28,79,7,Greater MN,2022-07-14
2021-08-07,Metro,3965,3738,227,3600,138,820,700,120,645,55,Metro,2022-07-14
2021-08-07,Northeast,950,534,416,522,12,120,70,50,66,4,Greater MN,2022-07-14
2021-08-07,Northwest,334,146,188,143,3,31,14,17,11,3,Greater MN,2022-07-14
2021-08-07,South Central,357,220,137,208,12,22,7,15,5,2,Greater MN,2022-07-14
2021-08-07,Southeast,1275,1050,225,1026,24,252,187,65,170,17,Greater MN,2022-07-14
2021-08-07,Southwest,360,121,239,118,3,11,2,9,2,0,Greater MN,2022-07-14
2021-08-07,State,8206,6464,1742,6246,218,1390,1074,316,986,88,State,2022-07-14
2021-08-07,West Central,208,73,135,72,1,20,8,12,8,0,Greater MN,2022-07-14
2020-08-08,Central,878,511,367,504,7,162,85,77,81,4,Greater MN,2022-07-14
2020-08-08,Metro,4736,3753,983,3585,168,871,696,175,629,67,Metro,2022-07-14
2020-08-08,Northeast,1133,547,586,541,6,114,75,39,72,3,Greater MN,2022-07-14
2020-08-08,Northwest,328,133,195,127,6,32,14,18,11,3,Greater MN,2022-07-14
2020-08-08,South Central,556,185,371,181,4,26,6,20,4,2,Greater MN,2022-07-14
2020-08-08,Southeast,1473,932,541,921,11,251,164,87,158,6,Greater MN,2022-07-14
2020-08-08,Southwest,375,101,274,99,2,17,5,12,5,0,Greater MN,2022-07-14
2020-08-08,State,9690,6240,3450,6036,204,1490,1050,440,965,85,State,2022-07-14
2020-08-08,West Central,211,78,133,78,0,17,5,12,5,0,Greater MN,2022-07-14
2021-08-08,Central,761,596,165,573,23,96,69,27,61,8,Greater MN,2022-07-14
2021-08-08,Metro,3875,3586,289,3439,147,823,683,140,630,53,Metro,2022-07-14
2021-08-08,Northeast,950,513,437,499,14,119,70,49,67,3,Greater MN,2022-07-14
2021-08-08,Northwest,334,153,181,148,5,31,10,21,7,3,Greater MN,2022-07-14
2021-08-08,South Central,357,216,141,204,12,22,6,16,4,2,Greater MN,2022-07-14
2021-08-08,Southeast,1272,968,304,946,22,250,159,91,143,16,Greater MN,2022-07-14
2021-08-08,Southwest,365,115,250,112,3,9,2,7,1,1,Greater MN,2022-07-14
2021-08-08,State,8122,6220,1902,5991,229,1370,1005,365,919,86,State,2022-07-14
2021-08-08,West Central,208,73,135,70,3,20,6,14,6,0,Greater MN,2022-07-14
2020-08-09,Central,860,483,377,477,6,159,79,80,73,6,Greater MN,2022-07-14
2020-08-09,Metro,4606,3624,982,3472,152,865,689,176,617,72,Metro,2022-07-14
2020-08-09,Northeast,1235,548,687,541,7,118,71,47,68,3,Greater MN,2022-07-14
2020-08-09,Northwest,327,120,207,113,7,32,17,15,14,3,Greater MN,2022-07-14
2020-08-09,South Central,531,173,358,169,4,26,7,19,5,2,Greater MN,2022-07-14
2020-08-09,Southeast,1473,881,592,868,13,251,140,111,136,4,Greater MN,2022-07-14
2020-08-09,Southwest,400,113,287,112,1,17,4,13,4,0,Greater MN,2022-07-14
2020-08-09,State,9643,6018,3625,5827,191,1485,1009,476,919,90,State,2022-07-14
2020-08-09,West Central,211,76,135,75,1,17,2,15,2,0,Greater MN,2022-07-14
2021-08-09,Central,766,595,171,566,29,96,64,32,56,8,Greater MN,2022-07-14
2021-08-09,Metro,3874,3524,350,3376,148,820,687,133,628,59,Metro,2022-07-14
2021-08-09,Northeast,949,528,421,509,19,120,74,46,70,4,Greater MN,2022-07-14
2021-08-09,Northwest,334,154,180,148,6,31,13,18,7,6,Greater MN,2022-07-14
2021-08-09,South Central,357,214,143,200,14,22,11,11,9,2,Greater MN,2022-07-14
2021-08-09,Southeast,1268,973,295,946,27,249,147,102,132,15,Greater MN,2022-07-14
2021-08-09,Southwest,365,114,251,111,3,12,4,8,3,1,Greater MN,2022-07-14
2021-08-09,State,8121,6177,1944,5928,249,1370,1005,365,910,95,State,2022-07-14
2021-08-09,West Central,208,75,133,72,3,20,5,15,5,0,Greater MN,2022-07-14
2020-08-10,Central,860,519,341,512,7,159,74,85,69,5,Greater MN,2022-07-14
2020-08-10,Metro,4452,3567,885,3427,140,812,615,197,555,60,Metro,2022-07-14
2020-08-10,Northeast,1133,561,572,555,6,114,69,45,66,3,Greater MN,2022-07-14
2020-08-10,Northwest,344,142,202,136,6,32,16,16,13,3,Greater MN,2022-07-14
2020-08-10,South Central,474,190,284,187,3,22,9,13,7,2,Greater MN,2022-07-14
2020-08-10,Southeast,1473,862,611,848,14,251,130,121,126,4,Greater MN,2022-07-14
2020-08-10,Southwest,403,117,286,116,1,21,4,17,4,0,Greater MN,2022-07-14
2020-08-10,State,9350,6034,3316,5856,178,1428,919,509,842,77,State,2022-07-14
2020-08-10,West Central,211,76,135,75,1,17,2,15,2,0,Greater MN,2022-07-14
2021-08-10,Central,788,631,157,604,27,102,75,27,65,10,Greater MN,2022-07-14
2021-08-10,Metro,3957,3707,250,3554,153,837,707,130,644,63,Metro,2022-07-14
2021-08-10,Northeast,949,537,412,518,19,120,75,45,71,4,Greater MN,2022-07-14
2021-08-10,Northwest,334,161,173,157,4,31,14,17,9,5,Greater MN,2022-07-14
2021-08-10,South Central,355,227,128,212,15,22,6,16,5,1,Greater MN,2022-07-14
2021-08-10,Southeast,1275,1034,241,1011,23,251,178,73,165,13,Greater MN,2022-07-14
2021-08-10,Southwest,371,123,248,117,6,12,4,8,3,1,Greater MN,2022-07-14
2021-08-10,State,8237,6508,1729,6259,249,1395,1065,330,968,97,State,2022-07-14
2021-08-10,West Central,208,88,120,86,2,20,6,14,6,0,Greater MN,2022-07-14
2020-08-11,Central,865,565,300,558,7,159,67,92,62,5,Greater MN,2022-07-14
2020-08-11,Metro,4777,4011,766,3856,155,917,712,205,637,75,Metro,2022-07-14
2020-08-11,Northeast,1122,595,527,587,8,114,69,45,66,3,Greater MN,2022-07-14
2020-08-11,Northwest,348,168,180,163,5,32,12,20,9,3,Greater MN,2022-07-14
2020-08-11,South Central,535,220,315,216,4,26,10,16,8,2,Greater MN,2022-07-14
2020-08-11,Southeast,1473,937,536,921,16,251,148,103,144,4,Greater MN,2022-07-14
2020-08-11,Southwest,410,130,280,129,1,19,3,16,3,0,Greater MN,2022-07-14
2020-08-11,State,9741,6718,3023,6521,197,1535,1024,511,931,93,State,2022-07-14
2020-08-11,State,0,0,0,0,0,0,0,0,-1,1,State,2022-07-14
2020-08-11,West Central,211,92,119,91,1,17,3,14,3,0,Greater MN,2022-07-14
2021-08-11,Central,847,697,150,659,38,102,75,27,66,9,Greater MN,2022-07-14
2021-08-11,Metro,4284,4042,242,3878,164,842,737,105,673,64,Metro,2022-07-14
2021-08-11,Northeast,952,561,391,544,17,120,79,41,72,7,Greater MN,2022-07-14
2021-08-11,Northwest,350,182,168,174,8,31,13,18,9,4,Greater MN,2022-07-14
2021-08-11,South Central,359,229,130,212,17,22,9,13,7,2,Greater MN,2022-07-14
2021-08-11,Southeast,1281,1064,217,1040,24,253,183,70,168,15,Greater MN,2022-07-14
2021-08-11,Southwest,382,134,248,130,4,13,7,6,5,2,Greater MN,2022-07-14
2021-08-11,State,8695,7035,1660,6761,274,1403,1109,294,1006,103,State,2022-07-14
2021-08-11,West Central,240,126,114,124,2,20,6,14,6,0,Greater MN,2022-07-14
2020-08-12,Central,908,606,302,597,9,165,80,85,75,5,Greater MN,2022-07-14
2020-08-12,Metro,4827,4155,672,4023,132,906,706,200,629,77,Metro,2022-07-14
2020-08-12,Northeast,1126,595,531,588,7,113,73,40,70,3,Greater MN,2022-07-14
2020-08-12,Northwest,344,170,174,167,3,32,14,18,11,3,Greater MN,2022-07-14
2020-08-12,South Central,509,211,298,207,4,26,10,16,9,1,Greater MN,2022-07-14
2020-08-12,Southeast,1473,956,517,942,14,251,157,94,154,3,Greater MN,2022-07-14
2020-08-12,Southwest,416,145,271,142,3,19,6,13,6,0,Greater MN,2022-07-14
2020-08-12,State,9814,6936,2878,6763,173,1529,1050,479,958,92,State,2022-07-14
2020-08-12,West Central,211,98,113,97,1,17,4,13,4,0,Greater MN,2022-07-14
2021-08-12,Central,799,655,144,616,39,100,68,32,58,10,Greater MN,2022-07-14
2021-08-12,Metro,4127,3873,254,3707,166,835,731,104,664,67,Metro,2022-07-14
2021-08-12,Northeast,954,556,398,542,14,119,72,47,66,6,Greater MN,2022-07-14
2021-08-12,Northwest,334,170,164,164,6,31,10,21,6,4,Greater MN,2022-07-14
2021-08-12,South Central,363,237,126,221,16,22,10,12,8,2,Greater MN,2022-07-14
2021-08-12,Southeast,1281,1080,201,1050,30,255,187,68,169,18,Greater MN,2022-07-14
2021-08-12,Southwest,371,134,237,129,5,13,7,6,5,2,Greater MN,2022-07-14
2021-08-12,State,8437,6802,1635,6523,279,1395,1094,301,984,110,State,2022-07-14
2021-08-12,West Central,208,97,111,94,3,20,9,11,8,1,Greater MN,2022-07-14
2020-08-13,Central,871,606,265,600,6,159,78,81,72,6,Greater MN,2022-07-14
2020-08-13,Metro,4801,4108,693,3974,134,894,693,201,620,73,Metro,2022-07-14
2020-08-13,Northeast,1123,590,533,585,5,114,64,50,62,2,Greater MN,2022-07-14
2020-08-13,Northwest,328,156,172,152,4,32,13,19,11,2,Greater MN,2022-07-14
2020-08-13,South Central,567,228,339,221,7,26,10,16,10,0,Greater MN,2022-07-14
2020-08-13,Southeast,1473,999,474,989,10,251,169,82,165,4,Greater MN,2022-07-14
2020-08-13,Southwest,416,128,288,125,3,19,3,16,3,0,Greater MN,2022-07-14
2020-08-13,State,9790,6905,2885,6734,171,1512,1034,478,947,87,State,2022-07-14
2020-08-13,West Central,211,90,121,88,2,17,4,13,4,0,Greater MN,2022-07-14
2021-08-13,Central,793,647,146,600,47,103,71,32,60,11,Greater MN,2022-07-14
2021-08-13,Metro,4060,3885,175,3705,180,842,737,105,673,64,Metro,2022-07-14
2021-08-13,Northeast,957,564,393,548,16,120,70,50,63,7,Greater MN,2022-07-14
2021-08-13,Northwest,334,166,168,159,7,31,10,21,7,3,Greater MN,2022-07-14
2021-08-13,South Central,358,217,141,202,15,22,10,12,9,1,Greater MN,2022-07-14
2021-08-13,Southeast,1282,1091,191,1063,28,256,191,65,170,21,Greater MN,2022-07-14
2021-08-13,Southwest,365,125,240,120,5,11,6,5,4,2,Greater MN,2022-07-14
2021-08-13,State,8357,6802,1555,6500,302,1405,1102,303,993,109,State,2022-07-14
2021-08-13,West Central,208,107,101,103,4,20,7,13,7,0,Greater MN,2022-07-14
2020-08-14,Central,883,581,302,576,5,165,75,90,68,7,Greater MN,2022-07-14
2020-08-14,Metro,4848,4038,810,3919,119,890,693,197,621,72,Metro,2022-07-14
2020-08-14,Northeast,1104,581,523,575,6,116,57,59,55,2,Greater MN,2022-07-14
2020-08-14,Northwest,339,152,187,147,5,32,16,16,14,2,Greater MN,2022-07-14
2020-08-14,South Central,567,217,350,210,7,26,9,17,9,0,Greater MN,2022-07-14
2020-08-14,Southeast,1473,1026,447,1016,10,251,152,99,148,4,Greater MN,2022-07-14
2020-08-14,Southwest,413,139,274,137,2,21,2,19,2,0,Greater MN,2022-07-14
2020-08-14,State,9815,6797,3018,6642,155,1519,1008,511,921,87,State,2022-07-14
2020-08-14,West Central,188,63,125,62,1,18,4,14,4,0,Greater MN,2022-07-14
2021-08-14,Central,780,613,167,571,42,103,75,28,59,16,Greater MN,2022-07-14
2021-08-14,Metro,3935,3720,215,3539,181,847,713,134,656,57,Metro,2022-07-14
2021-08-14,Northeast,954,510,444,495,15,119,73,46,67,6,Greater MN,2022-07-14
2021-08-14,Northwest,334,150,184,143,7,31,12,19,11,1,Greater MN,2022-07-14
2021-08-14,South Central,361,206,155,192,14,22,10,12,9,1,Greater MN,2022-07-14
2021-08-14,Southeast,1282,1046,236,1016,30,253,188,65,170,18,Greater MN,2022-07-14
2021-08-14,Southwest,370,131,239,126,5,12,5,7,5,0,Greater MN,2022-07-14
2021-08-14,State,8224,6468,1756,6168,300,1407,1081,326,982,99,State,2022-07-14
2021-08-14,West Central,208,92,116,86,6,20,5,15,5,0,Greater MN,2022-07-14
2020-08-15,Central,873,567,306,562,5,165,80,85,73,7,Greater MN,2022-07-14
2020-08-15,Metro,4748,3848,900,3740,108,816,700,116,624,76,Metro,2022-07-14
2020-08-15,Northeast,1109,565,544,560,5,116,63,53,61,2,Greater MN,2022-07-14
2020-08-15,Northwest,327,137,190,135,2,32,14,18,12,2,Greater MN,2022-07-14
2020-08-15,South Central,556,191,365,182,9,26,9,17,9,0,Greater MN,2022-07-14
2020-08-15,Southeast,1473,982,491,970,12,251,160,91,156,4,Greater MN,2022-07-14
2020-08-15,Southwest,375,110,265,110,0,18,1,17,1,0,Greater MN,2022-07-14
2020-08-15,State,9649,6467,3182,6325,142,1442,1029,413,938,91,State,2022-07-14
2020-08-15,West Central,188,67,121,66,1,18,2,16,2,0,Greater MN,2022-07-14
2021-08-15,Central,756,571,185,525,46,100,73,27,58,15,Greater MN,2022-07-14
2021-08-15,Metro,3800,3534,266,3353,181,822,691,131,631,60,Metro,2022-07-14
2021-08-15,Northeast,954,488,466,474,14,118,76,42,69,7,Greater MN,2022-07-14
2021-08-15,Northwest,334,147,187,139,8,31,10,21,9,1,Greater MN,2022-07-14
2021-08-15,South Central,358,207,151,194,13,22,10,12,9,1,Greater MN,2022-07-14
2021-08-15,Southeast,1276,973,303,938,35,256,173,83,157,16,Greater MN,2022-07-14
2021-08-15,Southwest,371,134,237,127,7,12,4,8,4,0,Greater MN,2022-07-14
2021-08-15,State,8057,6129,1928,5818,311,1381,1044,337,944,100,State,2022-07-14
2021-08-15,West Central,208,75,133,68,7,20,7,13,7,0,Greater MN,2022-07-14
2020-08-16,Central,870,487,383,481,6,165,71,94,66,5,Greater MN,2022-07-14
2020-08-16,Metro,4373,3424,949,3319,105,725,599,126,535,64,Metro,2022-07-14
2020-08-16,Northeast,1106,516,590,511,5,115,67,48,65,2,Greater MN,2022-07-14
2020-08-16,Northwest,327,122,205,119,3,32,12,20,11,1,Greater MN,2022-07-14
2020-08-16,South Central,531,177,354,166,11,26,9,17,8,1,Greater MN,2022-07-14
2020-08-16,Southeast,1473,883,590,870,13,251,135,116,130,5,Greater MN,2022-07-14
2020-08-16,Southwest,412,109,303,105,4,21,1,20,1,0,Greater MN,2022-07-14
2020-08-16,State,9222,5760,3462,5612,148,1346,896,450,818,78,State,2022-07-14
2020-08-16,West Central,130,42,88,41,1,11,2,9,2,0,Greater MN,2022-07-14
2021-08-16,Central,779,600,179,558,42,106,72,34,55,17,Greater MN,2022-07-14
2021-08-16,Metro,3831,3545,286,3350,195,832,710,122,642,68,Metro,2022-07-14
2021-08-16,Northeast,946,499,447,486,13,118,81,37,71,10,Greater MN,2022-07-14
2021-08-16,Northwest,334,165,169,155,10,31,8,23,7,1,Greater MN,2022-07-14
2021-08-16,South Central,366,208,158,195,13,24,9,15,8,1,Greater MN,2022-07-14
2021-08-16,Southeast,1263,968,295,934,34,252,166,86,149,17,Greater MN,2022-07-14
2021-08-16,Southwest,369,115,254,108,7,12,4,8,3,1,Greater MN,2022-07-14
2021-08-16,State,8096,6180,1916,5861,319,1395,1056,339,941,115,State,2022-07-14
2021-08-16,West Central,208,80,128,75,5,20,6,14,6,0,Greater MN,2022-07-14
2020-08-17,Central,896,507,389,500,7,165,72,93,68,4,Greater MN,2022-07-14
2020-08-17,Metro,4726,3854,872,3732,122,819,677,142,608,69,Metro,2022-07-14
2020-08-17,Northeast,1165,549,616,541,8,115,67,48,64,3,Greater MN,2022-07-14
2020-08-17,Northwest,335,141,194,139,2,32,11,21,10,1,Greater MN,2022-07-14
2020-08-17,South Central,506,192,314,182,10,24,8,16,7,1,Greater MN,2022-07-14
2020-08-17,Southeast,1473,877,596,862,15,251,140,111,134,6,Greater MN,2022-07-14
2020-08-17,Southwest,412,109,303,105,4,18,1,17,1,0,Greater MN,2022-07-14
2020-08-17,State,9721,6302,3419,6134,168,1444,984,460,900,84,State,2022-07-14
2020-08-17,West Central,208,73,135,73,0,20,8,12,8,0,Greater MN,2022-07-14
2021-08-17,Central,795,637,158,592,45,112,85,27,68,17,Greater MN,2022-07-14
2021-08-17,Metro,4042,3870,172,3669,201,831,726,105,648,78,Metro,2022-07-14
2021-08-17,Northeast,934,500,434,487,13,119,80,39,73,7,Greater MN,2022-07-14
2021-08-17,Northwest,334,172,162,159,13,31,17,14,17,0,Greater MN,2022-07-14
2021-08-17,South Central,357,233,124,219,14,22,8,14,7,1,Greater MN,2022-07-14
2021-08-17,Southeast,1283,1057,226,1017,40,252,191,61,170,21,Greater MN,2022-07-14
2021-08-17,Southwest,375,133,242,125,8,13,5,8,4,1,Greater MN,2022-07-14
2021-08-17,State,8328,6700,1628,6362,338,1400,1120,280,995,125,State,2022-07-14
2021-08-17,West Central,208,98,110,94,4,20,8,12,8,0,Greater MN,2022-07-14
2020-08-18,Central,897,581,316,569,12,165,73,92,70,3,Greater MN,2022-07-14
2020-08-18,Metro,4814,4105,709,3979,126,847,725,122,657,68,Metro,2022-07-14
2020-08-18,Northeast,1179,568,611,562,6,116,65,51,63,2,Greater MN,2022-07-14
2020-08-18,Northwest,339,143,196,142,1,32,12,20,11,1,Greater MN,2022-07-14
2020-08-18,South Central,565,228,337,216,12,28,13,15,12,1,Greater MN,2022-07-14
2020-08-18,Southeast,1473,932,541,918,14,251,153,98,148,5,Greater MN,2022-07-14
2020-08-18,Southwest,437,148,289,142,6,21,1,20,1,0,Greater MN,2022-07-14
2020-08-18,State,9912,6803,3109,6626,177,1480,1047,433,967,80,State,2022-07-14
2020-08-18,West Central,208,98,110,98,0,20,5,15,5,0,Greater MN,2022-07-14
2021-08-18,Central,825,685,140,640,45,115,84,31,67,17,Greater MN,2022-07-14
2021-08-18,Metro,4289,4107,182,3894,213,854,754,100,674,80,Metro,2022-07-14
2021-08-18,Northeast,946,545,401,526,19,120,81,39,75,6,Greater MN,2022-07-14
2021-08-18,Northwest,351,188,163,178,10,31,15,16,14,1,Greater MN,2022-07-14
2021-08-18,South Central,358,229,129,216,13,22,8,14,8,0,Greater MN,2022-07-14
2021-08-18,Southeast,1296,1067,229,1023,44,253,197,56,180,17,Greater MN,2022-07-14
2021-08-18,Southwest,393,136,257,130,6,13,4,9,4,0,Greater MN,2022-07-14
2021-08-18,State,8698,7089,1609,6734,355,1428,1148,280,1027,121,State,2022-07-14
2021-08-18,West Central,240,132,108,127,5,20,5,15,5,0,Greater MN,2022-07-14
2020-08-19,Central,898,605,293,591,14,166,84,82,81,3,Greater MN,2022-07-14
2020-08-19,Metro,4789,4094,695,3975,119,872,734,138,666,68,Metro,2022-07-14
2020-08-19,Northeast,1158,592,566,586,6,87,55,32,52,3,Greater MN,2022-07-14
2020-08-19,Northwest,346,156,190,156,0,25,12,13,12,0,Greater MN,2022-07-14
2020-08-19,South Central,567,227,340,213,14,26,7,19,6,1,Greater MN,2022-07-14
2020-08-19,Southeast,1473,961,512,946,15,251,165,86,159,6,Greater MN,2022-07-14
2020-08-19,Southwest,440,151,289,148,3,19,4,15,4,0,Greater MN,2022-07-14
2020-08-19,State,9879,6869,3010,6698,171,1466,1068,398,987,81,State,2022-07-14
2020-08-19,West Central,208,83,125,83,0,20,7,13,7,0,Greater MN,2022-07-14
2021-08-19,Central,788,640,148,604,36,109,83,26,63,20,Greater MN,2022-07-14
2021-08-19,Metro,4048,3844,204,3625,219,850,739,111,658,81,Metro,2022-07-14
2021-08-19,Northeast,957,536,421,517,19,119,81,38,75,6,Greater MN,2022-07-14
2021-08-19,Northwest,335,166,169,152,14,31,15,16,13,2,Greater MN,2022-07-14
2021-08-19,South Central,352,227,125,213,14,22,7,15,7,0,Greater MN,2022-07-14
2021-08-19,Southeast,1280,1062,218,1024,38,255,192,63,177,15,Greater MN,2022-07-14
2021-08-19,Southwest,369,123,246,117,6,14,5,9,5,0,Greater MN,2022-07-14
2021-08-19,State,8337,6698,1639,6345,353,1420,1128,292,1003,125,State,2022-07-14
2021-08-19,West Central,208,100,108,93,7,20,6,14,5,1,Greater MN,2022-07-14
2020-08-20,Central,892,568,324,558,10,166,79,87,76,3,Greater MN,2022-07-14
2020-08-20,Metro,4847,4075,772,3954,121,881,739,142,674,65,Metro,2022-07-14
2020-08-20,Northeast,1142,587,555,580,7,116,68,48,65,3,Greater MN,2022-07-14
2020-08-20,Northwest,340,160,180,158,2,32,9,23,9,0,Greater MN,2022-07-14
2020-08-20,South Central,567,242,325,229,13,26,10,16,10,0,Greater MN,2022-07-14
2020-08-20,Southeast,1473,973,500,955,18,251,160,91,156,4,Greater MN,2022-07-14
2020-08-20,Southwest,416,143,273,138,5,18,2,16,2,0,Greater MN,2022-07-14
2020-08-20,State,9885,6847,3038,6670,177,1510,1074,436,999,75,State,2022-07-14
2020-08-20,West Central,208,99,109,98,1,20,7,13,7,0,Greater MN,2022-07-14
2021-08-20,Central,790,636,154,596,40,108,82,26,62,20,Greater MN,2022-07-14
2021-08-20,Metro,4009,3795,214,3571,224,849,748,101,662,86,Metro,2022-07-14
2021-08-20,Northeast,951,538,413,519,19,120,78,42,68,10,Greater MN,2022-07-14
2021-08-20,Northwest,334,167,167,152,15,31,14,17,12,2,Greater MN,2022-07-14
2021-08-20,South Central,352,230,122,208,22,22,9,13,8,1,Greater MN,2022-07-14
2021-08-20,Southeast,1270,1051,219,1014,37,255,187,68,170,17,Greater MN,2022-07-14
2021-08-20,Southwest,375,127,248,116,11,13,6,7,6,0,Greater MN,2022-07-14
2021-08-20,State,8289,6637,1652,6262,375,1418,1130,288,992,138,State,2022-07-14
2021-08-20,West Central,208,93,115,86,7,20,6,14,4,2,Greater MN,2022-07-14
2020-08-21,Central,893,550,343,535,15,165,83,82,81,2,Greater MN,2022-07-14
2020-08-21,Metro,4867,4111,756,3985,126,852,740,112,677,63,Metro,2022-07-14
2020-08-21,Northeast,1196,590,606,582,8,118,70,48,67,3,Greater MN,2022-07-14
2020-08-21,Northwest,340,157,183,155,2,32,13,19,13,0,Greater MN,2022-07-14
2020-08-21,South Central,567,217,350,202,15,26,11,15,10,1,Greater MN,2022-07-14
2020-08-21,Southeast,1473,937,536,921,16,251,159,92,149,10,Greater MN,2022-07-14
2020-08-21,Southwest,415,148,267,142,6,18,1,17,1,0,Greater MN,2022-07-14
2020-08-21,State,9959,6800,3159,6612,188,1482,1082,400,1003,79,State,2022-07-14
2020-08-21,West Central,208,90,118,90,0,20,5,15,5,0,Greater MN,2022-07-14
2021-08-21,Central,776,615,161,579,36,105,79,26,60,19,Greater MN,2022-07-14
2021-08-21,Metro,3899,3648,251,3427,221,836,740,96,649,91,Metro,2022-07-14
2021-08-21,Northeast,951,505,446,488,17,119,86,33,71,15,Greater MN,2022-07-14
2021-08-21,Northwest,334,149,185,135,14,31,16,15,12,4,Greater MN,2022-07-14
2021-08-21,South Central,353,227,126,204,23,22,8,14,7,1,Greater MN,2022-07-14
2021-08-21,Southeast,1275,1016,259,980,36,250,183,67,164,19,Greater MN,2022-07-14
2021-08-21,Southwest,354,99,255,87,12,13,6,7,6,0,Greater MN,2022-07-14
2021-08-21,State,8150,6344,1806,5978,366,1396,1128,268,978,150,State,2022-07-14
2021-08-21,West Central,208,85,123,78,7,20,10,10,9,1,Greater MN,2022-07-14
2020-08-22,Central,901,560,341,550,10,165,80,85,80,0,Greater MN,2022-07-14
2020-08-22,Metro,4732,3826,906,3673,153,855,714,141,651,63,Metro,2022-07-14
2020-08-22,Northeast,1124,556,568,548,8,114,70,44,67,3,Greater MN,2022-07-14
2020-08-22,Northwest,304,130,174,127,3,27,7,20,7,0,Greater MN,2022-07-14
2020-08-22,South Central,531,193,338,182,11,26,7,19,5,2,Greater MN,2022-07-14
2020-08-22,Southeast,1474,908,566,894,14,251,169,82,158,11,Greater MN,2022-07-14
2020-08-22,Southwest,408,126,282,120,6,18,1,17,1,0,Greater MN,2022-07-14
2020-08-22,State,9682,6375,3307,6170,205,1476,1055,421,976,79,State,2022-07-14
2020-08-22,West Central,208,76,132,76,0,20,7,13,7,0,Greater MN,2022-07-14
2021-08-22,Central,742,568,174,532,36,102,76,26,55,21,Greater MN,2022-07-14
2021-08-22,Metro,3799,3521,278,3296,225,824,722,102,637,85,Metro,2022-07-14
2021-08-22,Northeast,953,496,457,480,16,120,80,40,66,14,Greater MN,2022-07-14
2021-08-22,Northwest,334,138,196,125,13,31,13,18,8,5,Greater MN,2022-07-14
2021-08-22,South Central,349,208,141,186,22,22,8,14,5,3,Greater MN,2022-07-14
2021-08-22,Southeast,1268,957,311,912,45,244,156,88,139,17,Greater MN,2022-07-14
2021-08-22,Southwest,364,104,260,90,14,13,4,9,4,0,Greater MN,2022-07-14
2021-08-22,State,8017,6077,1940,5702,375,1376,1069,307,924,145,State,2022-07-14
2021-08-22,West Central,208,85,123,81,4,20,10,10,10,0,Greater MN,2022-07-14
2020-08-23,Central,901,540,361,527,13,165,79,86,79,0,Greater MN,2022-07-14
2020-08-23,Metro,4390,3407,983,3263,144,746,600,146,543,57,Metro,2022-07-14
2020-08-23,Northeast,1225,539,686,531,8,118,68,50,65,3,Greater MN,2022-07-14
2020-08-23,Northwest,320,145,175,142,3,32,13,19,13,0,Greater MN,2022-07-14
2020-08-23,South Central,556,189,367,179,10,26,7,19,5,2,Greater MN,2022-07-14
2020-08-23,Southeast,1475,861,614,844,17,251,143,108,133,10,Greater MN,2022-07-14
2020-08-23,Southwest,408,116,292,108,8,18,2,16,2,0,Greater MN,2022-07-14
2020-08-23,State,9483,5859,3624,5656,203,1376,922,454,850,72,State,2022-07-14
2020-08-23,West Central,208,62,146,62,0,20,10,10,10,0,Greater MN,2022-07-14
2021-08-23,Central,776,611,165,570,41,106,81,25,55,26,Greater MN,2022-07-14
2021-08-23,Metro,3813,3545,268,3314,231,825,711,114,626,85,Metro,2022-07-14
2021-08-23,Northeast,953,497,456,482,15,119,79,40,66,13,Greater MN,2022-07-14
2021-08-23,Northwest,334,140,194,126,14,31,13,18,8,5,Greater MN,2022-07-14
2021-08-23,South Central,355,215,140,191,24,22,8,14,5,3,Greater MN,2022-07-14
2021-08-23,Southeast,1264,957,307,908,49,244,141,103,120,21,Greater MN,2022-07-14
2021-08-23,Southwest,368,108,260,93,15,12,4,8,4,0,Greater MN,2022-07-14
2021-08-23,State,8071,6161,1910,5765,396,1379,1045,334,892,153,State,2022-07-14
2021-08-23,West Central,208,88,120,81,7,20,8,12,8,0,Greater MN,2022-07-14
2020-08-24,Central,897,560,337,546,14,165,76,89,76,0,Greater MN,2022-07-14
2020-08-24,Metro,4754,3829,925,3673,156,842,696,146,627,69,Metro,2022-07-14
2020-08-24,Northeast,1123,559,564,548,11,113,80,33,76,4,Greater MN,2022-07-14
2020-08-24,Northwest,331,144,187,142,2,32,14,18,13,1,Greater MN,2022-07-14
2020-08-24,South Central,567,202,365,187,15,26,7,19,6,1,Greater MN,2022-07-14
2020-08-24,Southeast,1475,849,626,829,20,251,146,105,137,9,Greater MN,2022-07-14
2020-08-24,Southwest,435,119,316,110,9,21,2,19,2,0,Greater MN,2022-07-14
2020-08-24,State,9770,6331,3439,6104,227,1468,1027,441,943,84,State,2022-07-14
2020-08-24,West Central,188,69,119,69,0,18,6,12,6,0,Greater MN,2022-07-14
2021-08-24,Central,788,658,130,611,47,115,93,22,65,28,Greater MN,2022-07-14
2021-08-24,Metro,3989,3708,281,3460,248,837,738,99,653,85,Metro,2022-07-14
2021-08-24,Northeast,944,528,416,514,14,119,81,38,68,13,Greater MN,2022-07-14
2021-08-24,Northwest,334,172,162,156,16,31,17,14,11,6,Greater MN,2022-07-14
2021-08-24,South Central,360,228,132,210,18,22,10,12,6,4,Greater MN,2022-07-14
2021-08-24,Southeast,1272,985,287,933,52,249,169,80,147,22,Greater MN,2022-07-14
2021-08-24,Southwest,373,126,247,112,14,12,3,9,2,1,Greater MN,2022-07-14
2021-08-24,State,8268,6515,1753,6099,416,1405,1120,285,960,160,State,2022-07-14
2021-08-24,West Central,208,110,98,103,7,20,9,11,8,1,Greater MN,2022-07-14
2020-08-25,Central,896,625,271,610,15,165,83,82,83,0,Greater MN,2022-07-14
2020-08-25,Metro,4850,4086,764,3934,152,857,717,140,643,74,Metro,2022-07-14
2020-08-25,Northeast,749,428,321,420,8,91,55,36,53,2,Greater MN,2022-07-14
2020-08-25,Northwest,339,157,182,155,2,32,14,18,13,1,Greater MN,2022-07-14
2020-08-25,South Central,533,216,317,205,11,22,8,14,7,1,Greater MN,2022-07-14
2020-08-25,Southeast,1475,914,561,892,22,251,160,91,152,8,Greater MN,2022-07-14
2020-08-25,Southwest,435,133,302,126,7,21,3,18,3,0,Greater MN,2022-07-14
2020-08-25,State,9485,6640,2845,6422,218,1459,1048,411,962,86,State,2022-07-14
2020-08-25,West Central,208,81,127,80,1,20,8,12,8,0,Greater MN,2022-07-14
2021-08-25,Central,816,684,132,635,49,116,95,21,69,26,Greater MN,2022-07-14
2021-08-25,Metro,4237,3985,252,3729,256,852,752,100,659,93,Metro,2022-07-14
2021-08-25,Northeast,948,542,406,530,12,119,88,31,75,13,Greater MN,2022-07-14
2021-08-25,Northwest,351,189,162,172,17,31,15,16,8,7,Greater MN,2022-07-14
2021-08-25,South Central,362,236,126,213,23,22,10,12,6,4,Greater MN,2022-07-14
2021-08-25,Southeast,1277,1016,261,974,42,252,175,77,154,21,Greater MN,2022-07-14
2021-08-25,Southwest,388,132,256,117,15,11,3,8,2,1,Greater MN,2022-07-14
2021-08-25,State,8619,6928,1691,6509,419,1423,1141,282,976,165,State,2022-07-14
2021-08-25,West Central,240,144,96,139,5,20,3,17,3,0,Greater MN,2022-07-14
2020-08-26,Central,900,652,248,634,18,166,87,79,87,0,Greater MN,2022-07-14
2020-08-26,Metro,4907,4211,696,4067,144,854,714,140,638,76,Metro,2022-07-14
2020-08-26,Northeast,1211,609,602,598,11,118,71,47,66,5,Greater MN,2022-07-14
2020-08-26,Northwest,319,156,163,155,1,27,11,16,9,2,Greater MN,2022-07-14
2020-08-26,South Central,567,238,329,224,14,26,8,18,7,1,Greater MN,2022-07-14
2020-08-26,Southeast,1475,960,515,937,23,251,160,91,153,7,Greater MN,2022-07-14
2020-08-26,Southwest,435,125,310,120,5,21,3,18,3,0,Greater MN,2022-07-14
2020-08-26,State,10022,7037,2985,6820,217,1483,1063,420,972,91,State,2022-07-14
2020-08-26,West Central,208,86,122,85,1,20,9,11,9,0,Greater MN,2022-07-14
2021-08-26,Central,785,646,139,591,55,111,92,19,68,24,Greater MN,2022-07-14
2021-08-26,Metro,4096,3886,210,3636,250,856,754,102,663,91,Metro,2022-07-14
2021-08-26,Northeast,951,525,426,510,15,120,91,29,77,14,Greater MN,2022-07-14
2021-08-26,Northwest,334,163,171,147,16,31,15,16,7,8,Greater MN,2022-07-14
2021-08-26,South Central,363,238,125,217,21,22,11,11,5,6,Greater MN,2022-07-14
2021-08-26,Southeast,1267,1058,209,1008,50,252,193,59,171,22,Greater MN,2022-07-14
2021-08-26,Southwest,372,127,245,115,12,11,3,8,2,1,Greater MN,2022-07-14
2021-08-26,State,8376,6752,1624,6329,423,1423,1163,260,997,166,State,2022-07-14
2021-08-26,West Central,208,109,99,105,4,20,4,16,4,0,Greater MN,2022-07-14
2020-08-27,Central,899,633,266,616,17,167,99,68,99,0,Greater MN,2022-07-14
2020-08-27,Metro,4917,4223,694,4074,149,842,708,134,640,68,Metro,2022-07-14
2020-08-27,Northeast,1203,591,612,579,12,118,76,42,72,4,Greater MN,2022-07-14
2020-08-27,Northwest,339,149,190,148,1,32,11,21,9,2,Greater MN,2022-07-14
2020-08-27,South Central,570,216,354,201,15,23,7,16,6,1,Greater MN,2022-07-14
2020-08-27,Southeast,1475,951,524,932,19,251,170,81,164,6,Greater MN,2022-07-14
2020-08-27,Southwest,436,121,315,112,9,21,4,17,4,0,Greater MN,2022-07-14
2020-08-27,State,10047,6982,3065,6758,224,1474,1084,390,1003,81,State,2022-07-14
2020-08-27,West Central,208,98,110,96,2,20,9,11,9,0,Greater MN,2022-07-14
2021-08-27,Central,802,656,146,599,57,115,94,21,69,25,Greater MN,2022-07-14
2021-08-27,Metro,3998,3775,223,3523,252,845,752,93,663,89,Metro,2022-07-14
2021-08-27,Northeast,948,525,423,505,20,120,90,30,76,14,Greater MN,2022-07-14
2021-08-27,Northwest,334,160,174,144,16,31,15,16,7,8,Greater MN,2022-07-14
2021-08-27,South Central,363,227,136,205,22,22,10,12,4,6,Greater MN,2022-07-14
2021-08-27,Southeast,1284,1075,209,1028,47,252,183,69,163,20,Greater MN,2022-07-14
2021-08-27,Southwest,377,131,246,119,12,12,3,9,3,0,Greater MN,2022-07-14
2021-08-27,State,8314,6646,1668,6218,428,1417,1151,266,988,163,State,2022-07-14
2021-08-27,West Central,208,97,111,95,2,20,4,16,3,1,Greater MN,2022-07-14
2020-08-28,Central,877,586,291,567,19,165,94,71,91,3,Greater MN,2022-07-14
2020-08-28,Metro,4765,3972,793,3822,150,812,689,123,614,75,Metro,2022-07-14
2020-08-28,Northeast,1173,604,569,590,14,116,70,46,66,4,Greater MN,2022-07-14
2020-08-28,Northwest,331,152,179,151,1,32,14,18,12,2,Greater MN,2022-07-14
2020-08-28,South Central,525,210,315,199,11,26,7,19,6,1,Greater MN,2022-07-14
2020-08-28,Southeast,1418,947,471,928,19,251,166,85,160,6,Greater MN,2022-07-14
2020-08-28,Southwest,437,119,318,111,8,21,4,17,4,0,Greater MN,2022-07-14
2020-08-28,State,9735,6678,3057,6455,223,1442,1054,388,963,91,State,2022-07-14
2020-08-28,West Central,209,88,121,87,1,19,10,9,10,0,Greater MN,2022-07-14
2021-08-28,Central,761,616,145,564,52,102,85,17,60,25,Greater MN,2022-07-14
2021-08-28,Metro,3866,3612,254,3361,251,851,745,106,659,86,Metro,2022-07-14
2021-08-28,Northeast,940,471,469,454,17,119,85,34,70,15,Greater MN,2022-07-14
2021-08-28,Northwest,334,175,159,160,15,31,15,16,8,7,Greater MN,2022-07-14
2021-08-28,South Central,361,213,148,187,26,22,9,13,4,5,Greater MN,2022-07-14
2021-08-28,Southeast,1272,1061,211,1016,45,248,179,69,157,22,Greater MN,2022-07-14
2021-08-28,Southwest,372,118,254,107,11,11,0,11,0,0,Greater MN,2022-07-14
2021-08-28,State,8114,6348,1766,5927,421,1404,1121,283,960,161,State,2022-07-14
2021-08-28,West Central,208,82,126,78,4,20,3,17,2,1,Greater MN,2022-07-14
2020-08-29,Central,861,575,286,562,13,162,81,81,80,1,Greater MN,2022-07-14
2020-08-29,Metro,4638,3849,789,3684,165,796,689,107,620,69,Metro,2022-07-14
2020-08-29,Northeast,1117,570,547,560,10,114,68,46,62,6,Greater MN,2022-07-14
2020-08-29,Northwest,327,145,182,143,2,32,8,24,6,2,Greater MN,2022-07-14
2020-08-29,South Central,561,191,370,185,6,26,6,20,4,2,Greater MN,2022-07-14
2020-08-29,Southeast,1424,950,474,933,17,251,165,86,160,5,Greater MN,2022-07-14
2020-08-29,Southwest,401,107,294,97,10,21,3,18,3,0,Greater MN,2022-07-14
2020-08-29,State,9538,6471,3067,6247,224,1421,1027,394,942,85,State,2022-07-14
2020-08-29,West Central,209,84,125,83,1,19,7,12,7,0,Greater MN,2022-07-14
2021-08-29,Central,775,624,151,565,59,108,91,17,65,26,Greater MN,2022-07-14
2021-08-29,Metro,3819,3523,296,3287,236,837,736,101,654,82,Metro,2022-07-14
2021-08-29,Northeast,942,481,461,457,24,118,74,44,63,11,Greater MN,2022-07-14
2021-08-29,Northwest,334,153,181,140,13,31,15,16,6,9,Greater MN,2022-07-14
2021-08-29,South Central,358,215,143,190,25,22,8,14,5,3,Greater MN,2022-07-14
2021-08-29,Southeast,1277,1003,274,955,48,247,156,91,132,24,Greater MN,2022-07-14
2021-08-29,Southwest,378,122,256,109,13,12,2,10,2,0,Greater MN,2022-07-14
2021-08-29,State,8091,6206,1885,5783,423,1395,1086,309,931,155,State,2022-07-14
2021-08-29,West Central,208,85,123,80,5,20,4,16,4,0,Greater MN,2022-07-14
2020-08-30,Central,899,556,343,540,16,165,79,86,77,2,Greater MN,2022-07-14
2020-08-30,Metro,4769,3633,1136,3481,152,804,695,109,635,60,Metro,2022-07-14
2020-08-30,Northeast,1142,558,584,546,12,116,66,50,62,4,Greater MN,2022-07-14
2020-08-30,Northwest,327,128,199,125,3,32,5,27,3,2,Greater MN,2022-07-14
2020-08-30,South Central,482,162,320,155,7,26,6,20,5,1,Greater MN,2022-07-14
2020-08-30,Southeast,1448,861,587,845,16,251,145,106,138,7,Greater MN,2022-07-14
2020-08-30,Southwest,426,96,330,87,9,21,3,18,3,0,Greater MN,2022-07-14
2020-08-30,State,9702,6072,3630,5855,217,1434,1005,429,929,76,State,2022-07-14
2020-08-30,West Central,209,78,131,76,2,19,6,13,6,0,Greater MN,2022-07-14
2021-08-30,Central,790,648,142,599,49,108,88,20,61,27,Greater MN,2022-07-14
2021-08-30,Metro,3792,3496,296,3250,246,834,718,116,632,86,Metro,2022-07-14
2021-08-30,Northeast,943,498,445,472,26,119,80,39,67,13,Greater MN,2022-07-14
2021-08-30,Northwest,334,165,169,150,15,31,14,17,6,8,Greater MN,2022-07-14
2021-08-30,South Central,358,207,151,180,27,22,10,12,7,3,Greater MN,2022-07-14
2021-08-30,Southeast,1270,994,276,951,43,247,155,92,129,26,Greater MN,2022-07-14
2021-08-30,Southwest,377,123,254,108,15,12,2,10,1,1,Greater MN,2022-07-14
2021-08-30,State,8072,6218,1854,5793,425,1393,1069,324,905,164,State,2022-07-14
2021-08-30,West Central,208,87,121,83,4,20,2,18,2,0,Greater MN,2022-07-14
2020-08-31,Central,867,534,333,519,15,165,80,85,77,3,Greater MN,2022-07-14
2020-08-31,Metro,4464,3493,971,3337,156,805,683,122,613,70,Metro,2022-07-14
2020-08-31,Northeast,1232,576,656,564,12,118,60,58,56,4,Greater MN,2022-07-14
2020-08-31,Northwest,339,145,194,141,4,32,5,27,3,2,Greater MN,2022-07-14
2020-08-31,South Central,570,182,388,174,8,27,13,14,12,1,Greater MN,2022-07-14
2020-08-31,Southeast,1408,817,591,802,15,251,144,107,137,7,Greater MN,2022-07-14
2020-08-31,Southwest,431,101,330,92,9,21,3,18,3,0,Greater MN,2022-07-14
2020-08-31,State,9519,5922,3597,5702,220,1439,993,446,906,87,State,2022-07-14
2020-08-31,West Central,208,74,134,73,1,20,5,15,5,0,Greater MN,2022-07-14
2021-08-31,Central,848,658,190,604,54,110,91,19,64,27,Greater MN,2022-07-14
2021-08-31,Metro,3973,3737,236,3490,247,863,754,109,662,92,Metro,2022-07-14
2021-08-31,Northeast,944,518,426,489,29,120,78,42,68,10,Greater MN,2022-07-14
2021-08-31,Northwest,335,184,151,166,18,31,16,15,7,9,Greater MN,2022-07-14
2021-08-31,South Central,361,214,147,187,27,22,9,13,6,3,Greater MN,2022-07-14
2021-08-31,Southeast,1284,1020,264,972,48,248,182,66,153,29,Greater MN,2022-07-14
2021-08-31,Southwest,375,126,249,111,15,11,6,5,5,1,Greater MN,2022-07-14
2021-08-31,State,8328,6555,1773,6112,443,1425,1141,284,970,171,State,2022-07-14
2021-08-31,West Central,208,98,110,93,5,20,5,15,5,0,Greater MN,2022-07-14
2020-09-01,Central,827,572,255,557,15,161,93,68,92,1,Greater MN,2022-07-14
2020-09-01,Metro,4681,3778,903,3624,154,802,669,133,603,66,Metro,2022-07-14
2020-09-01,Northeast,1213,603,610,592,11,116,70,46,67,3,Greater MN,2022-07-14
2020-09-01,Northwest,339,158,181,154,4,32,9,23,7,2,Greater MN,2022-07-14
2020-09-01,South Central,571,205,366,198,7,26,9,17,7,2,Greater MN,2022-07-14
2020-09-01,Southeast,1410,901,509,887,14,251,156,95,148,8,Greater MN,2022-07-14
2020-09-01,Southwest,437,116,321,108,8,21,2,19,2,0,Greater MN,2022-07-14
2020-09-01,State,9686,6419,3267,6204,215,1429,1016,413,934,82,State,2022-07-14
2020-09-01,West Central,208,86,122,84,2,20,8,12,8,0,Greater MN,2022-07-14
2021-09-01,Central,826,680,146,627,53,116,95,21,68,27,Greater MN,2022-07-14
2021-09-01,Metro,4278,4030,248,3762,268,829,741,88,657,84,Metro,2022-07-14
2021-09-01,Northeast,956,554,402,523,31,118,86,32,76,10,Greater MN,2022-07-14
2021-09-01,Northwest,351,190,161,174,16,31,17,14,10,7,Greater MN,2022-07-14
2021-09-01,South Central,361,213,148,187,26,22,9,13,6,3,Greater MN,2022-07-14
2021-09-01,Southeast,1300,1063,237,1014,49,244,185,59,156,29,Greater MN,2022-07-14
2021-09-01,Southwest,383,123,260,106,17,13,7,6,5,2,Greater MN,2022-07-14
2021-09-01,State,8695,6991,1704,6524,467,1393,1145,248,983,162,State,2022-07-14
2021-09-01,West Central,240,138,102,131,7,20,5,15,5,0,Greater MN,2022-07-14
2020-09-02,Central,874,629,245,614,15,165,89,76,86,3,Greater MN,2022-07-14
2020-09-02,Metro,4907,3908,999,3760,148,818,682,136,611,71,Metro,2022-07-14
2020-09-02,Northeast,1169,605,564,594,11,114,74,40,70,4,Greater MN,2022-07-14
2020-09-02,Northwest,339,158,181,153,5,32,15,17,13,2,Greater MN,2022-07-14
2020-09-02,South Central,570,213,357,206,7,26,15,11,13,2,Greater MN,2022-07-14
2020-09-02,Southeast,1414,973,441,959,14,251,156,95,149,7,Greater MN,2022-07-14
2020-09-02,Southwest,437,122,315,114,8,21,3,18,3,0,Greater MN,2022-07-14
2020-09-02,State,9918,6700,3218,6492,208,1447,1041,406,952,89,State,2022-07-14
2020-09-02,West Central,208,92,116,92,0,20,7,13,7,0,Greater MN,2022-07-14
2021-09-02,Central,791,649,142,601,48,111,82,29,57,25,Greater MN,2022-07-14
2021-09-02,Metro,4124,3880,244,3622,258,834,737,97,649,88,Metro,2022-07-14
2021-09-02,Northeast,951,548,403,521,27,120,78,42,68,10,Greater MN,2022-07-14
2021-09-02,Northwest,335,178,157,160,18,31,20,11,14,6,Greater MN,2022-07-14
2021-09-02,South Central,365,223,142,193,30,22,7,15,4,3,Greater MN,2022-07-14
2021-09-02,Southeast,1289,1031,258,969,62,244,190,54,162,28,Greater MN,2022-07-14
2021-09-02,Southwest,375,127,248,113,14,12,6,6,5,1,Greater MN,2022-07-14
2021-09-02,State,8438,6751,1687,6289,462,1394,1126,268,963,163,State,2022-07-14
2021-09-02,West Central,208,115,93,110,5,20,6,14,4,2,Greater MN,2022-07-14
2020-09-03,Central,870,618,252,603,15,165,91,74,87,4,Greater MN,2022-07-14
2020-09-03,Metro,4775,3955,820,3821,134,812,682,130,617,65,Metro,2022-07-14
2020-09-03,Northeast,1168,579,589,565,14,143,75,68,70,5,Greater MN,2022-07-14
2020-09-03,Northwest,339,156,183,151,5,32,12,20,10,2,Greater MN,2022-07-14
2020-09-03,South Central,542,204,338,198,6,26,8,18,6,2,Greater MN,2022-07-14
2020-09-03,Southeast,1411,975,436,963,12,251,165,86,157,8,Greater MN,2022-07-14
2020-09-03,Southwest,435,121,314,113,8,21,1,20,1,0,Greater MN,2022-07-14
2020-09-03,State,9748,6701,3047,6506,195,1470,1039,431,953,86,State,2022-07-14
2020-09-03,West Central,208,93,115,92,1,20,5,15,5,0,Greater MN,2022-07-14
2021-09-03,Central,779,615,164,564,51,105,86,19,62,24,Greater MN,2022-07-14
2021-09-03,Metro,4036,3836,200,3574,262,832,737,95,650,87,Metro,2022-07-14
2021-09-03,Northeast,955,519,436,492,27,119,75,44,65,10,Greater MN,2022-07-14
2021-09-03,Northwest,335,190,145,174,16,31,18,13,14,4,Greater MN,2022-07-14
2021-09-03,South Central,364,213,151,185,28,22,7,15,3,4,Greater MN,2022-07-14
2021-09-03,Southeast,1289,1052,237,992,60,242,175,67,148,27,Greater MN,2022-07-14
2021-09-03,Southwest,372,134,238,124,10,10,3,7,2,1,Greater MN,2022-07-14
2021-09-03,State,8338,6662,1676,6204,458,1381,1108,273,950,158,State,2022-07-14
2021-09-03,West Central,208,103,105,99,4,20,7,13,6,1,Greater MN,2022-07-14
2020-09-04,Central,871,567,304,554,13,165,95,70,92,3,Greater MN,2022-07-14
2020-09-04,Metro,4671,3863,808,3721,142,819,705,114,639,66,Metro,2022-07-14
2020-09-04,Northeast,1174,587,587,575,12,145,78,67,73,5,Greater MN,2022-07-14
2020-09-04,Northwest,331,147,184,144,3,32,18,14,17,1,Greater MN,2022-07-14
2020-09-04,South Central,569,214,355,206,8,27,9,18,7,2,Greater MN,2022-07-14
2020-09-04,Southeast,1410,1005,405,992,13,251,165,86,158,7,Greater MN,2022-07-14
2020-09-04,Southwest,434,123,311,114,9,21,3,18,3,0,Greater MN,2022-07-14
2020-09-04,State,9668,6588,3080,6388,200,1480,1076,404,992,84,State,2022-07-14
2020-09-04,West Central,208,82,126,82,0,20,3,17,3,0,Greater MN,2022-07-14
2021-09-04,Central,774,617,157,563,54,108,93,15,62,31,Greater MN,2022-07-14
2021-09-04,Metro,3969,3738,231,3483,255,840,737,103,647,90,Metro,2022-07-14
2021-09-04,Northeast,956,501,455,483,18,117,76,41,64,12,Greater MN,2022-07-14
2021-09-04,Northwest,334,171,163,156,15,31,17,14,14,3,Greater MN,2022-07-14
2021-09-04,South Central,363,204,159,176,28,23,10,13,3,7,Greater MN,2022-07-14
2021-09-04,Southeast,1299,1003,296,946,57,247,173,74,147,26,Greater MN,2022-07-14
2021-09-04,Southwest,372,119,253,108,11,11,3,8,2,1,Greater MN,2022-07-14
2021-09-04,State,8275,6460,1815,6017,443,1397,1116,281,946,170,State,2022-07-14
2021-09-04,West Central,208,107,101,102,5,20,7,13,7,0,Greater MN,2022-07-14
2020-09-05,Central,877,532,345,519,13,165,94,71,90,4,Greater MN,2022-07-14
2020-09-05,Metro,4752,3641,1111,3502,139,829,712,117,644,68,Metro,2022-07-14
2020-09-05,Northeast,1160,570,590,559,11,143,67,76,64,3,Greater MN,2022-07-14
2020-09-05,Northwest,327,141,186,138,3,32,16,16,15,1,Greater MN,2022-07-14
2020-09-05,South Central,570,191,379,184,7,26,10,16,7,3,Greater MN,2022-07-14
2020-09-05,Southeast,1413,958,455,940,18,251,166,85,159,7,Greater MN,2022-07-14
2020-09-05,Southwest,434,114,320,107,7,21,1,20,1,0,Greater MN,2022-07-14
2020-09-05,State,9741,6234,3507,6034,200,1487,1071,416,985,86,State,2022-07-14
2020-09-05,West Central,208,87,121,85,2,20,5,15,5,0,Greater MN,2022-07-14
2021-09-05,Central,746,586,160,529,57,113,97,16,68,29,Greater MN,2022-07-14
2021-09-05,Metro,3869,3577,292,3318,259,822,721,101,624,97,Metro,2022-07-14
2021-09-05,Northeast,949,481,468,463,18,117,77,40,65,12,Greater MN,2022-07-14
2021-09-05,Northwest,334,162,172,150,12,31,15,16,12,3,Greater MN,2022-07-14
2021-09-05,South Central,366,212,154,176,36,22,8,14,2,6,Greater MN,2022-07-14
2021-09-05,Southeast,1287,915,372,860,55,246,160,86,131,29,Greater MN,2022-07-14
2021-09-05,Southwest,369,116,253,108,8,10,1,9,1,0,Greater MN,2022-07-14
2021-09-05,State,8128,6147,1981,5695,452,1381,1085,296,909,176,State,2022-07-14
2021-09-05,West Central,208,98,110,91,7,20,6,14,6,0,Greater MN,2022-07-14
2020-09-06,Central,871,536,335,521,15,165,92,73,90,2,Greater MN,2022-07-14
2020-09-06,Metro,4415,3500,915,3362,138,819,694,125,625,69,Metro,2022-07-14
2020-09-06,Northeast,1175,552,623,542,10,145,68,77,66,2,Greater MN,2022-07-14
2020-09-06,Northwest,327,148,179,144,4,32,8,24,7,1,Greater MN,2022-07-14
2020-09-06,South Central,570,178,392,173,5,26,5,21,3,2,Greater MN,2022-07-14
2020-09-06,Southeast,1413,871,542,855,16,251,152,99,145,7,Greater MN,2022-07-14
2020-09-06,Southwest,433,106,327,100,6,21,3,18,3,0,Greater MN,2022-07-14
2020-09-06,State,9412,5969,3443,5774,195,1479,1028,451,945,83,State,2022-07-14
2020-09-06,West Central,208,78,130,77,1,20,6,14,6,0,Greater MN,2022-07-14
2021-09-06,Central,742,589,153,528,61,108,89,19,63,26,Greater MN,2022-07-14
2021-09-06,Metro,3933,3540,393,3292,248,831,737,94,640,97,Metro,2022-07-14
2021-09-06,Northeast,954,502,452,476,26,119,81,38,70,11,Greater MN,2022-07-14
2021-09-06,Northwest,334,160,174,150,10,31,15,16,12,3,Greater MN,2022-07-14
2021-09-06,South Central,360,206,154,169,37,22,12,10,6,6,Greater MN,2022-07-14
2021-09-06,Southeast,1291,896,395,837,59,248,163,85,134,29,Greater MN,2022-07-14
2021-09-06,Southwest,371,113,258,103,10,12,2,10,2,0,Greater MN,2022-07-14
2021-09-06,State,8193,6105,2088,5648,457,1391,1106,285,932,174,State,2022-07-14
2021-09-06,West Central,208,99,109,93,6,20,7,13,5,2,Greater MN,2022-07-14
2020-09-07,Central,872,543,329,528,15,165,84,81,81,3,Greater MN,2022-07-14
2020-09-07,Metro,4529,3454,1075,3326,128,846,703,143,633,70,Metro,2022-07-14
2020-09-07,Northeast,1156,575,581,564,11,143,73,70,71,2,Greater MN,2022-07-14
2020-09-07,Northwest,339,139,200,136,3,32,8,24,7,1,Greater MN,2022-07-14
2020-09-07,South Central,570,180,390,173,7,26,9,17,7,2,Greater MN,2022-07-14
2020-09-07,Southeast,1411,841,570,826,15,251,140,111,133,7,Greater MN,2022-07-14
2020-09-07,Southwest,435,111,324,104,7,21,0,21,0,0,Greater MN,2022-07-14
2020-09-07,State,9520,5917,3603,5730,187,1504,1024,480,939,85,State,2022-07-14
2020-09-07,West Central,208,74,134,73,1,20,7,13,7,0,Greater MN,2022-07-14
2021-09-07,Central,766,622,144,566,56,103,85,18,57,28,Greater MN,2022-07-14
2021-09-07,Metro,3904,3645,259,3381,264,838,726,112,635,91,Metro,2022-07-14
2021-09-07,Northeast,952,519,433,491,28,115,76,39,63,13,Greater MN,2022-07-14
2021-09-07,Northwest,335,170,165,156,14,31,14,17,9,5,Greater MN,2022-07-14
2021-09-07,South Central,364,221,143,185,36,22,9,13,4,5,Greater MN,2022-07-14
2021-09-07,Southeast,1278,917,361,851,66,246,155,91,131,24,Greater MN,2022-07-14
2021-09-07,Southwest,370,110,260,97,13,11,5,6,3,2,Greater MN,2022-07-14
2021-09-07,State,8177,6297,1880,5813,484,1386,1079,307,907,172,State,2022-07-14
2021-09-07,West Central,208,93,115,86,7,20,9,11,5,4,Greater MN,2022-07-14
2020-09-08,Central,844,533,311,518,15,159,82,77,80,2,Greater MN,2022-07-14
2020-09-08,Metro,4478,3487,991,3363,124,823,694,129,623,71,Metro,2022-07-14
2020-09-08,Northeast,1180,606,574,594,12,142,86,56,84,2,Greater MN,2022-07-14
2020-09-08,Northwest,339,140,199,137,3,32,7,25,6,1,Greater MN,2022-07-14
2020-09-08,South Central,526,173,353,163,10,23,10,13,9,1,Greater MN,2022-07-14
2020-09-08,Southeast,1417,845,572,833,12,251,138,113,128,10,Greater MN,2022-07-14
2020-09-08,Southwest,435,115,320,107,8,21,1,20,1,0,Greater MN,2022-07-14
2020-09-08,State,9427,5977,3450,5792,185,1471,1023,448,936,87,State,2022-07-14
2020-09-08,West Central,208,78,130,77,1,20,5,15,5,0,Greater MN,2022-07-14
2021-09-08,Central,793,656,137,604,52,105,89,16,60,29,Greater MN,2022-07-14
2021-09-08,Metro,4211,3961,250,3687,274,855,756,99,659,97,Metro,2022-07-14
2021-09-08,Northeast,948,540,408,518,22,119,79,40,69,10,Greater MN,2022-07-14
2021-09-08,Northwest,352,201,151,185,16,31,13,18,8,5,Greater MN,2022-07-14
2021-09-08,South Central,365,232,133,196,36,22,11,11,5,6,Greater MN,2022-07-14
2021-09-08,Southeast,1291,1011,280,945,66,249,177,72,150,27,Greater MN,2022-07-14
2021-09-08,Southwest,386,128,258,114,14,13,5,8,3,2,Greater MN,2022-07-14
2021-09-08,State,8586,6875,1711,6387,488,1414,1139,275,960,179,State,2022-07-14
2021-09-08,West Central,240,146,94,138,8,20,9,11,6,3,Greater MN,2022-07-14
2020-09-09,Central,896,620,276,599,21,165,86,79,86,0,Greater MN,2022-07-14
2020-09-09,Metro,4889,4093,796,3989,104,855,727,128,655,72,Metro,2022-07-14
2020-09-09,Northeast,1178,623,555,615,8,145,76,69,74,2,Greater MN,2022-07-14
2020-09-09,Northwest,339,153,186,150,3,32,14,18,13,1,Greater MN,2022-07-14
2020-09-09,South Central,522,193,329,188,5,23,11,12,10,1,Greater MN,2022-07-14
2020-09-09,Southeast,1448,960,488,948,12,251,146,105,139,7,Greater MN,2022-07-14
2020-09-09,Southwest,436,111,325,106,5,21,1,20,1,0,Greater MN,2022-07-14
2020-09-09,State,9916,6836,3080,6677,159,1512,1065,447,982,83,State,2022-07-14
2020-09-09,West Central,208,83,125,82,1,20,4,16,4,0,Greater MN,2022-07-14
2021-09-09,Central,766,624,142,562,62,114,98,16,69,29,Greater MN,2022-07-14
2021-09-09,Metro,4077,3872,205,3579,293,862,765,97,662,103,Metro,2022-07-14
2021-09-09,Northeast,948,544,404,522,22,120,81,39,70,11,Greater MN,2022-07-14
2021-09-09,Northwest,336,188,148,175,13,31,16,15,11,5,Greater MN,2022-07-14
2021-09-09,South Central,367,241,126,204,37,22,11,11,4,7,Greater MN,2022-07-14
2021-09-09,Southeast,1294,1055,239,993,62,249,172,77,146,26,Greater MN,2022-07-14
2021-09-09,Southwest,373,130,243,117,13,13,5,8,3,2,Greater MN,2022-07-14
2021-09-09,State,8369,6776,1593,6266,510,1431,1155,276,970,185,State,2022-07-14
2021-09-09,West Central,208,122,86,114,8,20,7,13,5,2,Greater MN,2022-07-14
2020-09-10,Central,877,609,268,587,22,165,91,74,91,0,Greater MN,2022-07-14
2020-09-10,Metro,4745,3995,750,3876,119,827,713,114,636,77,Metro,2022-07-14
2020-09-10,Northeast,1181,619,562,610,9,142,72,70,70,2,Greater MN,2022-07-14
2020-09-10,Northwest,339,165,174,163,2,32,14,18,13,1,Greater MN,2022-07-14
2020-09-10,South Central,526,194,332,189,5,23,10,13,9,1,Greater MN,2022-07-14
2020-09-10,Southeast,1420,998,422,988,10,251,160,91,152,8,Greater MN,2022-07-14
2020-09-10,Southwest,434,121,313,115,6,21,4,17,4,0,Greater MN,2022-07-14
2020-09-10,State,9730,6803,2927,6628,175,1481,1071,410,982,89,State,2022-07-14
2020-09-10,West Central,208,102,106,100,2,20,7,13,7,0,Greater MN,2022-07-14
2021-09-10,Central,762,624,138,553,71,116,102,14,71,31,Greater MN,2022-07-14
2021-09-10,Metro,4116,3899,217,3627,272,857,754,103,649,105,Metro,2022-07-14
2021-09-10,Northeast,952,537,415,512,25,119,83,36,72,11,Greater MN,2022-07-14
2021-09-10,Northwest,336,193,143,176,17,31,15,16,7,8,Greater MN,2022-07-14
2021-09-10,South Central,366,235,131,198,37,22,12,10,6,6,Greater MN,2022-07-14
2021-09-10,Southeast,1296,1083,213,1030,53,249,171,78,149,22,Greater MN,2022-07-14
2021-09-10,Southwest,373,124,249,110,14,14,4,10,2,2,Greater MN,2022-07-14
2021-09-10,State,8409,6811,1598,6315,496,1428,1148,280,960,188,State,2022-07-14
2021-09-10,West Central,208,116,92,109,7,20,7,13,4,3,Greater MN,2022-07-14
2020-09-11,Central,868,560,308,539,21,165,89,76,89,0,Greater MN,2022-07-14
2020-09-11,Metro,4770,3952,818,3840,112,824,719,105,649,70,Metro,2022-07-14
2020-09-11,Northeast,1180,621,559,608,13,143,69,74,68,1,Greater MN,2022-07-14
2020-09-11,Northwest,339,164,175,162,2,32,9,23,9,0,Greater MN,2022-07-14
2020-09-11,South Central,570,208,362,203,5,26,10,16,8,2,Greater MN,2022-07-14
2020-09-11,Southeast,1419,1013,406,1003,10,251,163,88,155,8,Greater MN,2022-07-14
2020-09-11,Southwest,434,124,310,115,9,21,6,15,6,0,Greater MN,2022-07-14
2020-09-11,State,9788,6748,3040,6575,173,1482,1072,410,991,81,State,2022-07-14
2020-09-11,West Central,208,106,102,105,1,20,7,13,7,0,Greater MN,2022-07-14
2021-09-11,Central,756,600,156,533,67,110,96,14,68,28,Greater MN,2022-07-14
2021-09-11,Metro,3978,3753,225,3495,258,844,757,87,654,103,Metro,2022-07-14
2021-09-11,Northeast,959,522,437,502,20,119,78,41,67,11,Greater MN,2022-07-14
2021-09-11,Northwest,336,164,172,150,14,31,14,17,6,8,Greater MN,2022-07-14
2021-09-11,South Central,367,218,149,183,35,22,13,9,8,5,Greater MN,2022-07-14
2021-09-11,Southeast,1300,1039,261,1000,39,251,182,69,155,27,Greater MN,2022-07-14
2021-09-11,Southwest,368,124,244,113,11,13,5,8,3,2,Greater MN,2022-07-14
2021-09-11,State,8272,6514,1758,6060,454,1410,1152,258,966,186,State,2022-07-14
2021-09-11,West Central,208,94,114,84,10,20,7,13,5,2,Greater MN,2022-07-14
2020-09-12,Central,874,561,313,545,16,165,84,81,81,3,Greater MN,2022-07-14
2020-09-12,Metro,4566,3741,825,3630,111,811,696,115,627,69,Metro,2022-07-14
2020-09-12,Northeast,1178,597,581,585,12,142,77,65,75,2,Greater MN,2022-07-14
2020-09-12,Northwest,327,141,186,138,3,32,10,22,10,0,Greater MN,2022-07-14
2020-09-12,South Central,570,190,380,184,6,26,7,19,6,1,Greater MN,2022-07-14
2020-09-12,Southeast,1415,964,451,953,11,251,164,87,157,7,Greater MN,2022-07-14
2020-09-12,Southwest,434,130,304,122,8,21,0,21,0,0,Greater MN,2022-07-14
2020-09-12,State,9572,6422,3150,6255,167,1468,1043,425,961,82,State,2022-07-14
2020-09-12,West Central,208,98,110,98,0,20,5,15,5,0,Greater MN,2022-07-14
2021-09-12,Central,739,571,168,505,66,106,92,14,64,28,Greater MN,2022-07-14
2021-09-12,Metro,3889,3631,258,3351,280,830,730,100,627,103,Metro,2022-07-14
2021-09-12,Northeast,959,520,439,487,33,120,78,42,67,11,Greater MN,2022-07-14
2021-09-12,Northwest,334,166,168,152,14,31,13,18,5,8,Greater MN,2022-07-14
2021-09-12,South Central,362,220,142,186,34,24,12,12,6,6,Greater MN,2022-07-14
2021-09-12,Southeast,1302,1008,294,965,43,250,167,83,140,27,Greater MN,2022-07-14
2021-09-12,Southwest,363,109,254,98,11,12,3,9,2,1,Greater MN,2022-07-14
2021-09-12,State,8156,6312,1844,5823,489,1393,1104,289,914,190,State,2022-07-14
2021-09-12,West Central,208,87,121,79,8,20,9,11,3,6,Greater MN,2022-07-14
2020-09-13,Central,875,544,331,527,17,165,75,90,72,3,Greater MN,2022-07-14
2020-09-13,Metro,4433,3584,849,3481,103,820,696,124,621,75,Metro,2022-07-14
2020-09-13,Northeast,1163,569,594,556,13,143,78,65,77,1,Greater MN,2022-07-14
2020-09-13,Northwest,327,129,198,127,2,32,13,19,13,0,Greater MN,2022-07-14
2020-09-13,South Central,570,177,393,171,6,26,10,16,9,1,Greater MN,2022-07-14
2020-09-13,Southeast,1415,915,500,904,11,251,149,102,140,9,Greater MN,2022-07-14
2020-09-13,Southwest,424,130,294,120,10,21,1,20,1,0,Greater MN,2022-07-14
2020-09-13,State,9415,6132,3283,5970,162,1478,1026,452,937,89,State,2022-07-14
2020-09-13,West Central,208,84,124,84,0,20,4,16,4,0,Greater MN,2022-07-14
2021-09-13,Central,774,605,169,527,78,98,87,11,59,28,Greater MN,2022-07-14
2021-09-13,Metro,3860,3571,289,3265,306,845,739,106,626,113,Metro,2022-07-14
2021-09-13,Northeast,958,532,426,494,38,119,79,40,67,12,Greater MN,2022-07-14
2021-09-13,Northwest,334,176,158,158,18,31,16,15,4,12,Greater MN,2022-07-14
2021-09-13,South Central,368,223,145,184,39,23,14,9,7,7,Greater MN,2022-07-14
2021-09-13,Southeast,1304,989,315,948,41,251,165,86,137,28,Greater MN,2022-07-14
2021-09-13,Southwest,364,117,247,103,14,12,4,8,2,2,Greater MN,2022-07-14
2021-09-13,State,8170,6305,1865,5764,541,1399,1113,286,905,208,State,2022-07-14
2021-09-13,West Central,208,92,116,85,7,20,9,11,3,6,Greater MN,2022-07-14
2020-09-14,Central,842,529,313,508,21,159,72,87,69,3,Greater MN,2022-07-14
2020-09-14,Metro,4412,3574,838,3466,108,807,680,127,607,73,Metro,2022-07-14
2020-09-14,Northeast,1174,577,597,563,14,143,70,73,68,2,Greater MN,2022-07-14
2020-09-14,Northwest,283,129,154,127,2,22,10,12,10,0,Greater MN,2022-07-14
2020-09-14,South Central,570,177,393,170,7,26,10,16,10,0,Greater MN,2022-07-14
2020-09-14,Southeast,1414,887,527,874,13,252,131,121,123,8,Greater MN,2022-07-14
2020-09-14,Southwest,433,132,301,122,10,21,1,20,1,0,Greater MN,2022-07-14
2020-09-14,State,9336,6093,3243,5917,176,1450,979,471,893,86,State,2022-07-14
2020-09-14,West Central,208,88,120,87,1,20,5,15,5,0,Greater MN,2022-07-14
2021-09-14,Central,802,675,127,606,69,108,93,15,64,29,Greater MN,2022-07-14
2021-09-14,Metro,3980,3742,238,3459,283,854,740,114,623,117,Metro,2022-07-14
2021-09-14,Northeast,960,558,402,522,36,120,74,46,63,11,Greater MN,2022-07-14
2021-09-14,Northwest,335,186,149,167,19,31,16,15,6,10,Greater MN,2022-07-14
2021-09-14,South Central,369,237,132,189,48,23,12,11,4,8,Greater MN,2022-07-14
2021-09-14,Southeast,1298,1057,241,1020,37,251,185,66,157,28,Greater MN,2022-07-14
2021-09-14,Southwest,368,127,241,115,12,11,4,7,3,1,Greater MN,2022-07-14
2021-09-14,State,8320,6694,1626,6184,510,1418,1132,286,924,208,State,2022-07-14
2021-09-14,West Central,208,112,96,106,6,20,8,12,4,4,Greater MN,2022-07-14
2020-09-15,Central,868,589,279,569,20,165,89,76,83,6,Greater MN,2022-07-14
2020-09-15,Metro,4541,3804,737,3691,113,843,723,120,647,76,Metro,2022-07-14
2020-09-15,Northeast,1147,599,548,583,16,143,74,69,72,2,Greater MN,2022-07-14
2020-09-15,Northwest,339,175,164,173,2,32,14,18,14,0,Greater MN,2022-07-14
2020-09-15,South Central,570,207,363,198,9,26,11,15,11,0,Greater MN,2022-07-14
2020-09-15,Southeast,1422,990,432,979,11,251,167,84,159,8,Greater MN,2022-07-14
2020-09-15,Southwest,434,134,300,128,6,20,2,18,2,0,Greater MN,2022-07-14
2020-09-15,State,9529,6614,2915,6435,179,1500,1086,414,994,92,State,2022-07-14
2020-09-15,West Central,208,116,92,114,2,20,6,14,6,0,Greater MN,2022-07-14
2021-09-15,Central,828,709,119,652,57,112,95,17,61,34,Greater MN,2022-07-14
2021-09-15,Metro,4203,3983,220,3700,283,851,738,113,627,111,Metro,2022-07-14
2021-09-15,Northeast,959,559,400,523,36,120,74,46,62,12,Greater MN,2022-07-14
2021-09-15,Northwest,350,190,160,172,18,31,15,16,4,11,Greater MN,2022-07-14
2021-09-15,South Central,367,232,135,181,51,23,12,11,2,10,Greater MN,2022-07-14
2021-09-15,Southeast,1313,1100,213,1054,46,251,201,50,175,26,Greater MN,2022-07-14
2021-09-15,Southwest,395,136,259,119,17,14,5,9,4,1,Greater MN,2022-07-14
2021-09-15,State,8655,7043,1612,6527,516,1422,1146,276,936,210,State,2022-07-14
2021-09-15,West Central,240,134,106,126,8,20,6,14,1,5,Greater MN,2022-07-14
2020-09-16,Central,865,605,260,582,23,166,99,67,93,6,Greater MN,2022-07-14
2020-09-16,Metro,4676,3895,781,3795,100,827,696,131,625,71,Metro,2022-07-14
2020-09-16,Northeast,1177,614,563,598,16,144,75,69,73,2,Greater MN,2022-07-14
2020-09-16,Northwest,339,162,177,160,2,32,13,19,13,0,Greater MN,2022-07-14
2020-09-16,South Central,561,215,346,210,5,26,8,18,8,0,Greater MN,2022-07-14
2020-09-16,Southeast,1414,1002,412,990,12,251,178,73,172,6,Greater MN,2022-07-14
2020-09-16,Southwest,434,135,299,129,6,21,5,16,5,0,Greater MN,2022-07-14
2020-09-16,State,9674,6749,2925,6583,166,1487,1079,408,994,85,State,2022-07-14
2020-09-16,West Central,208,121,87,119,2,20,5,15,5,0,Greater MN,2022-07-14
2021-09-16,Central,785,649,136,591,58,113,96,17,60,36,Greater MN,2022-07-14
2021-09-16,Metro,4055,3867,188,3595,272,853,746,107,636,110,Metro,2022-07-14
2021-09-16,Northeast,953,540,413,504,36,120,73,47,60,13,Greater MN,2022-07-14
2021-09-16,Northwest,334,178,156,158,20,31,15,16,4,11,Greater MN,2022-07-14
2021-09-16,South Central,369,223,146,178,45,24,14,10,4,10,Greater MN,2022-07-14
2021-09-16,Southeast,1295,1078,217,1027,51,249,193,56,170,23,Greater MN,2022-07-14
2021-09-16,Southwest,373,133,240,115,18,12,6,6,4,2,Greater MN,2022-07-14
2021-09-16,State,8372,6786,1586,6277,509,1422,1151,271,940,211,State,2022-07-14
2021-09-16,West Central,208,118,90,109,9,20,8,12,2,6,Greater MN,2022-07-14
2020-09-17,Central,877,612,265,594,18,166,108,58,101,7,Greater MN,2022-07-14
2020-09-17,Metro,4695,3982,713,3876,106,822,692,130,626,66,Metro,2022-07-14
2020-09-17,Northeast,1160,527,633,511,16,144,74,70,73,1,Greater MN,2022-07-14
2020-09-17,Northwest,339,167,172,165,2,32,16,16,16,0,Greater MN,2022-07-14
2020-09-17,South Central,551,210,341,205,5,26,11,15,11,0,Greater MN,2022-07-14
2020-09-17,Southeast,1415,1015,400,1005,10,251,175,76,167,8,Greater MN,2022-07-14
2020-09-17,Southwest,433,138,295,134,4,21,3,18,3,0,Greater MN,2022-07-14
2020-09-17,State,9678,6779,2899,6616,163,1482,1084,398,1002,82,State,2022-07-14
2020-09-17,West Central,208,128,80,126,2,20,5,15,5,0,Greater MN,2022-07-14
2021-09-17,Central,817,676,141,619,57,111,95,16,57,38,Greater MN,2022-07-14
2021-09-17,Metro,4082,3899,183,3616,283,846,747,99,624,123,Metro,2022-07-14
2021-09-17,Northeast,957,539,418,504,35,119,76,43,63,13,Greater MN,2022-07-14
2021-09-17,Northwest,335,185,150,164,21,31,16,15,2,14,Greater MN,2022-07-14
2021-09-17,South Central,367,238,129,192,46,24,12,12,2,10,Greater MN,2022-07-14
2021-09-17,Southeast,1296,1093,203,1034,59,250,196,54,170,26,Greater MN,2022-07-14
2021-09-17,Southwest,386,137,249,119,18,12,4,8,2,2,Greater MN,2022-07-14
2021-09-17,State,8448,6873,1575,6346,527,1413,1152,261,922,230,State,2022-07-14
2021-09-17,West Central,208,106,102,98,8,20,6,14,2,4,Greater MN,2022-07-14
2020-09-18,Central,878,638,240,617,21,165,100,65,94,6,Greater MN,2022-07-14
2020-09-18,Metro,4388,3642,746,3540,102,742,613,129,552,61,Metro,2022-07-14
2020-09-18,Northeast,1163,605,558,590,15,142,77,65,75,2,Greater MN,2022-07-14
2020-09-18,Northwest,327,172,155,169,3,32,18,14,18,0,Greater MN,2022-07-14
2020-09-18,South Central,570,207,363,201,6,26,8,18,8,0,Greater MN,2022-07-14
2020-09-18,Southeast,1417,1023,394,1013,10,251,176,75,169,7,Greater MN,2022-07-14
2020-09-18,Southwest,414,119,295,116,3,18,4,14,4,0,Greater MN,2022-07-14
2020-09-18,State,9365,6529,2836,6366,163,1396,1003,393,927,76,State,2022-07-14
2020-09-18,West Central,208,123,85,120,3,20,7,13,7,0,Greater MN,2022-07-14
2021-09-18,Central,790,650,140,585,65,104,92,12,56,36,Greater MN,2022-07-14
2021-09-18,Metro,3936,3741,195,3448,293,833,743,90,630,113,Metro,2022-07-14
2021-09-18,Northeast,965,497,468,466,31,112,79,33,65,14,Greater MN,2022-07-14
2021-09-18,Northwest,335,174,161,155,19,31,14,17,2,12,Greater MN,2022-07-14
2021-09-18,South Central,364,231,133,182,49,24,13,11,5,8,Greater MN,2022-07-14
2021-09-18,Southeast,1298,1084,214,1022,62,251,194,57,168,26,Greater MN,2022-07-14
2021-09-18,Southwest,372,140,232,118,22,11,3,8,3,0,Greater MN,2022-07-14
2021-09-18,State,8268,6618,1650,6069,549,1386,1146,240,933,213,State,2022-07-14
2021-09-18,West Central,208,101,107,93,8,20,8,12,4,4,Greater MN,2022-07-14
2020-09-19,Central,826,585,241,561,24,159,90,69,84,6,Greater MN,2022-07-14
2020-09-19,Metro,4536,3800,736,3686,114,815,694,121,628,66,Metro,2022-07-14
2020-09-19,Northeast,1163,569,594,550,19,142,75,67,73,2,Greater MN,2022-07-14
2020-09-19,Northwest,329,161,168,159,2,32,12,20,12,0,Greater MN,2022-07-14
2020-09-19,South Central,545,177,368,171,6,26,10,16,10,0,Greater MN,2022-07-14
2020-09-19,Southeast,1412,988,424,979,9,251,163,88,157,6,Greater MN,2022-07-14
2020-09-19,Southwest,433,124,309,117,7,21,5,16,5,0,Greater MN,2022-07-14
2020-09-19,State,9452,6517,2935,6334,183,1466,1055,411,975,80,State,2022-07-14
2020-09-19,West Central,208,113,95,111,2,20,6,14,6,0,Greater MN,2022-07-14
2021-09-19,Central,762,614,148,551,63,101,84,17,49,35,Greater MN,2022-07-14
2021-09-19,Metro,3832,3583,249,3281,302,822,717,105,596,121,Metro,2022-07-14
2021-09-19,Northeast,960,490,470,456,34,112,74,38,61,13,Greater MN,2022-07-14
2021-09-19,Northwest,334,180,154,161,19,31,15,16,0,15,Greater MN,2022-07-14
2021-09-19,South Central,367,228,139,182,46,25,13,12,3,10,Greater MN,2022-07-14
2021-09-19,Southeast,1298,983,315,919,64,253,171,82,140,31,Greater MN,2022-07-14
2021-09-19,Southwest,367,114,253,93,21,12,3,9,3,0,Greater MN,2022-07-14
2021-09-19,State,8128,6282,1846,5722,560,1376,1085,291,857,228,State,2022-07-14
2021-09-19,West Central,208,90,118,79,11,20,8,12,5,3,Greater MN,2022-07-14
2020-09-20,Central,870,554,316,531,23,165,81,84,73,8,Greater MN,2022-07-14
2020-09-20,Metro,4389,3581,808,3467,114,786,671,115,598,73,Metro,2022-07-14
2020-09-20,Northeast,1182,585,597,566,19,141,77,64,76,1,Greater MN,2022-07-14
2020-09-20,Northwest,329,162,167,158,4,32,11,21,11,0,Greater MN,2022-07-14
2020-09-20,South Central,570,175,395,169,6,26,8,18,7,1,Greater MN,2022-07-14
2020-09-20,Southeast,1409,885,524,877,8,251,151,100,143,8,Greater MN,2022-07-14
2020-09-20,Southwest,429,120,309,110,10,21,7,14,7,0,Greater MN,2022-07-14
2020-09-20,State,9386,6152,3234,5966,186,1442,1011,431,920,91,State,2022-07-14
2020-09-20,West Central,208,90,118,88,2,20,5,15,5,0,Greater MN,2022-07-14
2021-09-20,Central,761,623,138,555,68,102,80,22,49,31,Greater MN,2022-07-14
2021-09-20,Metro,3870,3640,230,3347,293,834,723,111,600,123,Metro,2022-07-14
2021-09-20,Northeast,946,490,456,457,33,114,76,38,62,14,Greater MN,2022-07-14
2021-09-20,Northwest,334,184,150,160,24,31,15,16,1,14,Greater MN,2022-07-14
2021-09-20,South Central,370,235,135,180,55,25,13,12,4,9,Greater MN,2022-07-14
2021-09-20,Southeast,1291,977,314,909,68,252,168,84,141,27,Greater MN,2022-07-14
2021-09-20,Southwest,372,124,248,105,19,11,5,6,3,2,Greater MN,2022-07-14
2021-09-20,State,8152,6371,1781,5802,569,1389,1086,303,864,222,State,2022-07-14
2021-09-20,West Central,208,98,110,89,9,20,6,14,4,2,Greater MN,2022-07-14
2020-09-21,Central,871,542,329,522,20,165,88,77,78,10,Greater MN,2022-07-14
2020-09-21,Metro,4444,3596,848,3474,122,801,673,128,597,76,Metro,2022-07-14
2020-09-21,Northeast,1233,596,637,576,20,145,81,64,80,1,Greater MN,2022-07-14
2020-09-21,Northwest,339,171,168,166,5,32,12,20,11,1,Greater MN,2022-07-14
2020-09-21,South Central,570,187,383,183,4,26,10,16,9,1,Greater MN,2022-07-14
2020-09-21,Southeast,1409,853,556,843,10,251,146,105,137,9,Greater MN,2022-07-14
2020-09-21,Southwest,431,121,310,111,10,21,5,16,5,0,Greater MN,2022-07-14
2020-09-21,State,9505,6150,3355,5957,193,1461,1020,441,922,98,State,2022-07-14
2020-09-21,West Central,208,84,124,82,2,20,5,15,5,0,Greater MN,2022-07-14
2021-09-21,Central,772,663,109,588,75,102,81,21,51,30,Greater MN,2022-07-14
2021-09-21,Metro,4019,3841,178,3526,315,845,728,117,608,120,Metro,2022-07-14
2021-09-21,Northeast,950,496,454,470,26,114,79,35,64,15,Greater MN,2022-07-14
2021-09-21,Northwest,334,172,162,152,20,31,16,15,5,11,Greater MN,2022-07-14
2021-09-21,South Central,375,229,146,178,51,22,10,12,2,8,Greater MN,2022-07-14
2021-09-21,Southeast,1301,1026,275,960,66,250,188,62,162,26,Greater MN,2022-07-14
2021-09-21,Southwest,386,135,251,120,15,12,5,7,2,3,Greater MN,2022-07-14
2021-09-21,State,8345,6675,1670,6095,580,1396,1110,286,896,214,State,2022-07-14
2021-09-21,West Central,208,113,95,101,12,20,3,17,2,1,Greater MN,2022-07-14
2020-09-22,Central,877,593,284,570,23,165,106,59,90,16,Greater MN,2022-07-14
2020-09-22,Metro,4738,3994,744,3861,133,731,633,98,561,72,Metro,2022-07-14
2020-09-22,Northeast,1170,600,570,579,21,143,78,65,76,2,Greater MN,2022-07-14
2020-09-22,Northwest,339,193,146,187,6,32,18,14,17,1,Greater MN,2022-07-14
2020-09-22,South Central,570,203,367,195,8,26,8,18,7,1,Greater MN,2022-07-14
2020-09-22,Southeast,1415,922,493,909,13,251,160,91,151,9,Greater MN,2022-07-14
2020-09-22,Southwest,428,112,316,98,14,21,5,16,5,0,Greater MN,2022-07-14
2020-09-22,State,9745,6716,3029,6495,221,1389,1013,376,912,101,State,2022-07-14
2020-09-22,West Central,208,99,109,96,3,20,5,15,5,0,Greater MN,2022-07-14
2021-09-22,Central,825,714,111,646,68,105,85,20,52,33,Greater MN,2022-07-14
2021-09-22,Metro,4280,4067,213,3751,316,845,738,107,621,117,Metro,2022-07-14
2021-09-22,Northeast,935,536,399,503,33,112,78,34,65,13,Greater MN,2022-07-14
2021-09-22,Northwest,350,174,176,149,25,31,18,13,5,13,Greater MN,2022-07-14
2021-09-22,South Central,370,241,129,198,43,22,11,11,4,7,Greater MN,2022-07-14
2021-09-22,Southeast,1321,1131,190,1069,62,254,198,56,173,25,Greater MN,2022-07-14
2021-09-22,Southwest,402,143,259,133,10,12,7,5,2,5,Greater MN,2022-07-14
2021-09-22,State,8723,7155,1568,6587,568,1401,1140,261,926,214,State,2022-07-14
2021-09-22,West Central,240,149,91,138,11,20,5,15,4,1,Greater MN,2022-07-14
2020-09-23,Central,878,618,260,596,22,165,97,68,83,14,Greater MN,2022-07-14
2020-09-23,Metro,4744,4070,674,3934,136,821,700,121,625,75,Metro,2022-07-14
2020-09-23,Northeast,1169,645,524,627,18,142,79,63,78,1,Greater MN,2022-07-14
2020-09-23,Northwest,339,185,154,180,5,32,16,16,15,1,Greater MN,2022-07-14
2020-09-23,South Central,570,235,335,228,7,26,12,14,11,1,Greater MN,2022-07-14
2020-09-23,Southeast,1415,952,463,938,14,251,158,93,149,9,Greater MN,2022-07-14
2020-09-23,Southwest,433,134,299,122,12,21,6,15,4,2,Greater MN,2022-07-14
2020-09-23,State,9756,6940,2816,6723,217,1478,1074,404,971,103,State,2022-07-14
2020-09-23,West Central,208,101,107,98,3,20,6,14,6,0,Greater MN,2022-07-14
2021-09-23,Central,784,660,124,592,68,106,89,17,55,34,Greater MN,2022-07-14
2021-09-23,Metro,4027,3822,205,3528,294,827,733,94,619,114,Metro,2022-07-14
2021-09-23,Northeast,956,545,411,510,35,114,81,33,68,13,Greater MN,2022-07-14
2021-09-23,Northwest,334,187,147,166,21,31,18,13,5,13,Greater MN,2022-07-14
2021-09-23,South Central,368,234,134,189,45,22,10,12,2,8,Greater MN,2022-07-14
2021-09-23,Southeast,1311,1115,196,1057,58,252,184,68,159,25,Greater MN,2022-07-14
2021-09-23,Southwest,381,142,239,132,10,12,5,7,1,4,Greater MN,2022-07-14
2021-09-23,State,8369,6811,1558,6267,544,1384,1127,257,914,213,State,2022-07-14
2021-09-23,West Central,208,106,102,93,13,20,7,13,5,2,Greater MN,2022-07-14
2020-09-24,Central,879,612,267,583,29,165,98,67,85,13,Greater MN,2022-07-14
2020-09-24,Metro,4775,4070,705,3916,154,821,720,101,641,79,Metro,2022-07-14
2020-09-24,Northeast,1179,653,526,632,21,143,75,68,74,1,Greater MN,2022-07-14
2020-09-24,Northwest,339,189,150,182,7,32,16,16,15,1,Greater MN,2022-07-14
2020-09-24,South Central,570,229,341,224,5,26,8,18,6,2,Greater MN,2022-07-14
2020-09-24,Southeast,1416,979,437,960,19,251,163,88,152,11,Greater MN,2022-07-14
2020-09-24,Southwest,433,144,289,136,8,21,5,16,2,3,Greater MN,2022-07-14
2020-09-24,State,9799,6977,2822,6731,246,1479,1090,389,980,110,State,2022-07-14
2020-09-24,West Central,208,101,107,98,3,20,5,15,5,0,Greater MN,2022-07-14
2021-09-24,Central,769,629,140,568,61,102,85,17,53,32,Greater MN,2022-07-14
2021-09-24,Metro,4008,3839,169,3538,301,830,726,104,611,115,Metro,2022-07-14
2021-09-24,Northeast,946,556,390,515,41,114,75,39,59,16,Greater MN,2022-07-14
2021-09-24,Northwest,334,177,157,158,19,31,15,16,5,10,Greater MN,2022-07-14
2021-09-24,South Central,364,238,126,191,47,22,11,11,4,7,Greater MN,2022-07-14
2021-09-24,Southeast,1305,1112,193,1062,50,251,184,67,157,27,Greater MN,2022-07-14
2021-09-24,Southwest,377,135,242,124,11,10,4,6,1,3,Greater MN,2022-07-14
2021-09-24,State,8311,6807,1504,6263,544,1380,1107,273,895,212,State,2022-07-14
2021-09-24,West Central,208,121,87,107,14,20,7,13,5,2,Greater MN,2022-07-14
2020-09-25,Central,881,611,270,576,35,165,100,65,81,19,Greater MN,2022-07-14
2020-09-25,Metro,4743,4069,674,3923,146,816,693,123,611,82,Metro,2022-07-14
2020-09-25,Northeast,1161,598,563,579,19,142,69,73,65,4,Greater MN,2022-07-14
2020-09-25,Northwest,339,178,161,170,8,32,12,20,12,0,Greater MN,2022-07-14
2020-09-25,South Central,574,207,367,203,4,22,12,10,10,2,Greater MN,2022-07-14
2020-09-25,Southeast,1411,1006,405,985,21,251,178,73,167,11,Greater MN,2022-07-14
2020-09-25,Southwest,433,155,278,140,15,21,5,16,2,3,Greater MN,2022-07-14
2020-09-25,State,9750,6919,2831,6669,250,1469,1074,395,953,121,State,2022-07-14
2020-09-25,West Central,208,95,113,93,2,20,5,15,5,0,Greater MN,2022-07-14
2021-09-25,Central,752,602,150,532,70,98,80,18,50,30,Greater MN,2022-07-14
2021-09-25,Metro,3980,3756,224,3463,293,814,725,89,611,114,Metro,2022-07-14
2021-09-25,Northeast,925,538,387,503,35,114,71,43,56,15,Greater MN,2022-07-14
2021-09-25,Northwest,334,167,167,146,21,31,14,17,5,9,Greater MN,2022-07-14
2021-09-25,South Central,364,238,126,197,41,22,11,11,4,7,Greater MN,2022-07-14
2021-09-25,Southeast,1313,1064,249,1010,54,252,193,59,164,29,Greater MN,2022-07-14
2021-09-25,Southwest,376,137,239,127,10,11,3,8,0,3,Greater MN,2022-07-14
2021-09-25,State,8252,6616,1636,6075,541,1362,1103,259,895,208,State,2022-07-14
2021-09-25,West Central,208,114,94,97,17,20,6,14,5,1,Greater MN,2022-07-14
2020-09-26,Central,880,569,311,541,28,165,99,66,75,24,Greater MN,2022-07-14
2020-09-26,Metro,4704,4010,694,3864,146,822,697,125,617,80,Metro,2022-07-14
2020-09-26,Northeast,1173,614,559,598,16,143,71,72,67,4,Greater MN,2022-07-14
2020-09-26,Northwest,327,151,176,145,6,32,18,14,17,1,Greater MN,2022-07-14
2020-09-26,South Central,574,193,381,186,7,22,8,14,5,3,Greater MN,2022-07-14
2020-09-26,Southeast,1411,1032,379,1012,20,251,172,79,159,13,Greater MN,2022-07-14
2020-09-26,Southwest,427,141,286,117,24,21,7,14,4,3,Greater MN,2022-07-14
2020-09-26,State,9704,6796,2908,6546,250,1476,1079,397,951,128,State,2022-07-14
2020-09-26,West Central,208,86,122,83,3,20,7,13,7,0,Greater MN,2022-07-14
2021-09-26,Central,734,567,167,508,59,100,80,20,48,32,Greater MN,2022-07-14
2021-09-26,Metro,3835,3568,267,3272,296,819,714,105,609,105,Metro,2022-07-14
2021-09-26,Northeast,936,534,402,486,48,114,77,37,63,14,Greater MN,2022-07-14
2021-09-26,Northwest,334,164,170,144,20,31,15,16,4,11,Greater MN,2022-07-14
2021-09-26,South Central,364,210,154,171,39,22,10,12,4,6,Greater MN,2022-07-14
2021-09-26,Southeast,1309,977,332,924,53,252,182,70,154,28,Greater MN,2022-07-14
2021-09-26,Southwest,373,136,237,124,12,11,4,7,1,3,Greater MN,2022-07-14
2021-09-26,State,8093,6269,1824,5725,544,1369,1088,281,888,200,State,2022-07-14
2021-09-26,West Central,208,113,95,96,17,20,6,14,5,1,Greater MN,2022-07-14
2020-09-27,Central,883,572,311,531,41,165,90,75,71,19,Greater MN,2022-07-14
2020-09-27,Metro,4470,3732,738,3581,151,835,701,134,619,82,Metro,2022-07-14
2020-09-27,Northeast,1181,601,580,587,14,145,78,67,73,5,Greater MN,2022-07-14
2020-09-27,Northwest,339,160,179,155,5,32,14,18,12,2,Greater MN,2022-07-14
2020-09-27,South Central,575,195,380,182,13,21,9,12,6,3,Greater MN,2022-07-14
2020-09-27,Southeast,1414,945,469,919,26,251,160,91,143,17,Greater MN,2022-07-14
2020-09-27,Southwest,428,143,285,114,29,20,3,17,1,2,Greater MN,2022-07-14
2020-09-27,State,9498,6440,3058,6158,282,1489,1063,426,933,130,State,2022-07-14
2020-09-27,West Central,208,92,116,89,3,20,8,12,8,0,Greater MN,2022-07-14
2021-09-27,Central,743,601,142,526,75,102,84,18,53,31,Greater MN,2022-07-14
2021-09-27,Metro,3884,3628,256,3337,291,837,723,114,618,105,Metro,2022-07-14
2021-09-27,Northeast,948,533,415,479,54,112,78,34,68,10,Greater MN,2022-07-14
2021-09-27,Northwest,334,166,168,147,19,31,19,12,7,12,Greater MN,2022-07-14
2021-09-27,South Central,365,215,150,172,43,22,11,11,5,6,Greater MN,2022-07-14
2021-09-27,Southeast,1305,982,323,925,57,251,180,71,154,26,Greater MN,2022-07-14
2021-09-27,Southwest,377,130,247,115,15,12,6,6,3,3,Greater MN,2022-07-14
2021-09-27,State,8164,6369,1795,5797,572,1387,1111,276,915,196,State,2022-07-14
2021-09-27,West Central,208,114,94,96,18,20,10,10,7,3,Greater MN,2022-07-14
2020-09-28,Central,886,566,320,521,45,162,93,69,77,16,Greater MN,2022-07-14
2020-09-28,Metro,4498,3766,732,3617,149,820,686,134,600,86,Metro,2022-07-14
2020-09-28,Northeast,1182,624,558,604,20,145,80,65,73,7,Greater MN,2022-07-14
2020-09-28,Northwest,339,151,188,143,8,32,13,19,12,1,Greater MN,2022-07-14
2020-09-28,South Central,575,201,374,187,14,21,9,12,6,3,Greater MN,2022-07-14
2020-09-28,Southeast,1416,909,507,878,31,251,153,98,139,14,Greater MN,2022-07-14
2020-09-28,Southwest,440,145,295,118,27,21,3,18,1,2,Greater MN,2022-07-14
2020-09-28,State,9544,6451,3093,6152,299,1472,1046,426,917,129,State,2022-07-14
2020-09-28,West Central,208,89,119,84,5,20,9,11,9,0,Greater MN,2022-07-14
2021-09-28,Central,786,677,109,585,92,104,84,20,55,29,Greater MN,2022-07-14
2021-09-28,Metro,4043,3829,214,3541,288,839,748,91,643,105,Metro,2022-07-14
2021-09-28,Northeast,934,533,401,476,57,114,95,19,81,14,Greater MN,2022-07-14
2021-09-28,Northwest,334,177,157,158,19,31,18,13,5,13,Greater MN,2022-07-14
2021-09-28,South Central,366,230,136,194,36,23,12,11,6,6,Greater MN,2022-07-14
2021-09-28,Southeast,1300,1072,228,1003,69,252,189,63,156,33,Greater MN,2022-07-14
2021-09-28,Southwest,373,148,225,133,15,12,5,7,3,2,Greater MN,2022-07-14
2021-09-28,State,8344,6792,1552,6196,596,1395,1161,234,955,206,State,2022-07-14
2021-09-28,West Central,208,126,82,106,20,20,10,10,6,4,Greater MN,2022-07-14
2020-09-29,Central,878,609,269,567,42,162,96,66,80,16,Greater MN,2022-07-14
2020-09-29,Metro,4282,3663,619,3520,143,750,616,134,551,65,Metro,2022-07-14
2020-09-29,Northeast,1182,633,549,610,23,145,75,70,72,3,Greater MN,2022-07-14
2020-09-29,Northwest,339,159,180,151,8,32,14,18,13,1,Greater MN,2022-07-14
2020-09-29,South Central,524,221,303,207,14,22,9,13,7,2,Greater MN,2022-07-14
2020-09-29,Southeast,1413,981,432,946,35,251,172,79,160,12,Greater MN,2022-07-14
2020-09-29,Southwest,443,146,297,124,22,21,4,17,2,2,Greater MN,2022-07-14
2020-09-29,State,9269,6514,2755,6223,291,1403,993,410,892,101,State,2022-07-14
2020-09-29,West Central,208,102,106,98,4,20,7,13,7,0,Greater MN,2022-07-14
2021-09-29,Central,835,733,102,637,96,113,91,22,62,29,Greater MN,2022-07-14
2021-09-29,Metro,4235,4029,206,3747,282,850,756,94,647,109,Metro,2022-07-14
2021-09-29,Northeast,941,557,384,505,52,112,86,26,69,17,Greater MN,2022-07-14
2021-09-29,Northwest,349,187,162,166,21,32,21,11,10,11,Greater MN,2022-07-14
2021-09-29,South Central,372,240,132,204,36,22,9,13,2,7,Greater MN,2022-07-14
2021-09-29,Southeast,1321,1134,187,1070,64,251,194,57,164,30,Greater MN,2022-07-14
2021-09-29,Southwest,391,164,227,147,17,11,3,8,2,1,Greater MN,2022-07-14
2021-09-29,State,8684,7214,1470,6630,584,1411,1167,244,960,207,State,2022-07-14
2021-09-29,West Central,240,170,70,154,16,20,7,13,4,3,Greater MN,2022-07-14
2020-09-30,Central,883,646,237,607,39,162,90,72,75,15,Greater MN,2022-07-14
2020-09-30,Metro,4728,4027,701,3869,158,837,695,142,614,81,Metro,2022-07-14
2020-09-30,Northeast,1179,647,532,625,22,145,80,65,77,3,Greater MN,2022-07-14
2020-09-30,Northwest,339,164,175,153,11,32,14,18,13,1,Greater MN,2022-07-14
2020-09-30,South Central,575,206,369,194,12,21,10,11,8,2,Greater MN,2022-07-14
2020-09-30,Southeast,1415,1039,376,1006,33,251,169,82,156,13,Greater MN,2022-07-14
2020-09-30,Southwest,443,154,289,129,25,21,3,18,2,1,Greater MN,2022-07-14
2020-09-30,State,9770,6993,2777,6688,305,1489,1067,422,951,116,State,2022-07-14
2020-09-30,West Central,208,110,98,105,5,20,6,14,6,0,Greater MN,2022-07-14
2021-09-30,Central,798,688,110,599,89,118,101,17,65,36,Greater MN,2022-07-14
2021-09-30,Metro,4020,3886,134,3588,298,860,759,101,652,107,Metro,2022-07-14
2021-09-30,Northeast,927,543,384,492,51,112,80,32,64,16,Greater MN,2022-07-14
2021-09-30,Northwest,334,175,159,154,21,31,19,12,6,13,Greater MN,2022-07-14
2021-09-30,South Central,370,235,135,201,34,22,12,10,5,7,Greater MN,2022-07-14
2021-09-30,Southeast,1313,1150,163,1086,64,250,200,50,172,28,Greater MN,2022-07-14
2021-09-30,Southwest,379,155,224,137,18,12,4,8,3,1,Greater MN,2022-07-14
2021-09-30,State,8349,6947,1402,6355,592,1425,1185,240,973,212,State,2022-07-14
2021-09-30,West Central,208,115,93,98,17,20,10,10,6,4,Greater MN,2022-07-14
2020-10-01,Central,885,598,287,556,42,162,97,65,85,12,Greater MN,2022-07-14
2020-10-01,Metro,4795,4052,743,3914,138,817,689,128,612,77,Metro,2022-07-14
2020-10-01,Northeast,1176,629,547,606,23,145,79,66,75,4,Greater MN,2022-07-14
2020-10-01,Northwest,339,179,160,168,11,32,14,18,13,1,Greater MN,2022-07-14
2020-10-01,South Central,575,194,381,181,13,21,7,14,5,2,Greater MN,2022-07-14
2020-10-01,Southeast,1421,1033,388,998,35,251,163,88,152,11,Greater MN,2022-07-14
2020-10-01,Southwest,417,147,270,128,19,21,6,15,4,2,Greater MN,2022-07-14
2020-10-01,State,9816,6943,2873,6656,287,1469,1062,407,953,109,State,2022-07-14
2020-10-01,West Central,208,111,97,105,6,20,7,13,7,0,Greater MN,2022-07-14
2021-10-01,Central,813,682,131,589,93,113,94,19,57,37,Greater MN,2022-07-14
2021-10-01,Metro,4082,3931,151,3644,287,845,751,94,640,111,Metro,2022-07-14
2021-10-01,Northeast,939,530,409,472,58,107,81,26,62,19,Greater MN,2022-07-14
2021-10-01,Northwest,334,184,150,154,30,31,15,16,3,12,Greater MN,2022-07-14
2021-10-01,South Central,375,234,141,201,33,22,8,14,4,4,Greater MN,2022-07-14
2021-10-01,Southeast,1320,1115,205,1046,69,252,202,50,176,26,Greater MN,2022-07-14
2021-10-01,Southwest,373,149,224,131,18,10,3,7,2,1,Greater MN,2022-07-14
2021-10-01,State,8444,6937,1507,6331,606,1400,1162,238,948,214,State,2022-07-14
2021-10-01,West Central,208,112,96,94,18,20,8,12,4,4,Greater MN,2022-07-14
2020-10-02,Central,942,579,363,547,32,162,96,66,81,15,Greater MN,2022-07-14
2020-10-02,Metro,4713,4027,686,3893,134,805,680,125,599,81,Metro,2022-07-14
2020-10-02,Northeast,1240,629,611,609,20,147,76,71,72,4,Greater MN,2022-07-14
2020-10-02,Northwest,339,192,147,178,14,32,10,22,9,1,Greater MN,2022-07-14
2020-10-02,South Central,575,210,365,195,15,21,8,13,4,4,Greater MN,2022-07-14
2020-10-02,Southeast,1418,1019,399,988,31,251,161,90,151,10,Greater MN,2022-07-14
2020-10-02,Southwest,468,151,317,136,15,21,4,17,3,1,Greater MN,2022-07-14
2020-10-02,State,9903,6900,3003,6638,262,1459,1043,416,927,116,State,2022-07-14
2020-10-02,West Central,208,93,115,92,1,20,8,12,8,0,Greater MN,2022-07-14
2021-10-02,Central,766,630,136,538,92,107,89,18,55,34,Greater MN,2022-07-14
2021-10-02,Metro,3966,3770,196,3487,283,846,756,90,651,105,Metro,2022-07-14
2021-10-02,Northeast,937,509,428,439,70,109,72,37,51,21,Greater MN,2022-07-14
2021-10-02,Northwest,334,182,152,151,31,31,16,15,4,12,Greater MN,2022-07-14
2021-10-02,South Central,364,224,140,193,31,22,12,10,7,5,Greater MN,2022-07-14
2021-10-02,Southeast,1304,1039,265,972,67,253,207,46,181,26,Greater MN,2022-07-14
2021-10-02,Southwest,366,124,242,108,16,10,4,6,3,1,Greater MN,2022-07-14
2021-10-02,State,8245,6584,1661,5977,607,1398,1165,233,957,208,State,2022-07-14
2021-10-02,West Central,208,106,102,89,17,20,9,11,5,4,Greater MN,2022-07-14
2020-10-03,Central,938,583,355,558,25,162,100,62,84,16,Greater MN,2022-07-14
2020-10-03,Metro,4613,3894,719,3777,117,812,678,134,595,83,Metro,2022-07-14
2020-10-03,Northeast,1211,590,621,569,21,143,73,70,69,4,Greater MN,2022-07-14
2020-10-03,Northwest,339,166,173,151,15,32,15,17,12,3,Greater MN,2022-07-14
2020-10-03,South Central,575,207,368,191,16,21,9,12,7,2,Greater MN,2022-07-14
2020-10-03,Southeast,1421,994,427,966,28,248,148,100,138,10,Greater MN,2022-07-14
2020-10-03,Southwest,468,131,337,117,14,21,2,19,1,1,Greater MN,2022-07-14
2020-10-03,State,9773,6640,3133,6403,237,1459,1029,430,910,119,State,2022-07-14
2020-10-03,West Central,208,75,133,74,1,20,4,16,4,0,Greater MN,2022-07-14
2021-10-03,Central,753,621,132,529,92,114,97,17,62,35,Greater MN,2022-07-14
2021-10-03,Metro,3896,3640,256,3343,297,848,747,101,638,109,Metro,2022-07-14
2021-10-03,Northeast,933,499,434,425,74,110,72,38,53,19,Greater MN,2022-07-14
2021-10-03,Northwest,334,170,164,140,30,31,12,19,2,10,Greater MN,2022-07-14
2021-10-03,South Central,368,228,140,193,35,22,12,10,5,7,Greater MN,2022-07-14
2021-10-03,Southeast,1303,996,307,929,67,253,190,63,166,24,Greater MN,2022-07-14
2021-10-03,Southwest,357,116,241,103,13,10,4,6,1,3,Greater MN,2022-07-14
2021-10-03,State,8152,6370,1782,5747,623,1408,1143,265,934,209,State,2022-07-14
2021-10-03,West Central,208,100,108,85,15,20,9,11,7,2,Greater MN,2022-07-14
2020-10-04,Central,936,574,362,546,28,162,93,69,78,15,Greater MN,2022-07-14
2020-10-04,Metro,4516,3738,778,3602,136,798,653,145,571,82,Metro,2022-07-14
2020-10-04,Northeast,1236,577,659,560,17,147,72,75,65,7,Greater MN,2022-07-14
2020-10-04,Northwest,339,157,182,142,15,32,16,16,12,4,Greater MN,2022-07-14
2020-10-04,South Central,573,178,395,166,12,21,7,14,5,2,Greater MN,2022-07-14
2020-10-04,Southeast,1415,902,513,874,28,251,137,114,127,10,Greater MN,2022-07-14
2020-10-04,Southwest,468,108,360,97,11,21,3,18,2,1,Greater MN,2022-07-14
2020-10-04,State,9691,6298,3393,6048,250,1452,982,470,861,121,State,2022-07-14
2020-10-04,West Central,208,64,144,61,3,20,1,19,1,0,Greater MN,2022-07-14
2021-10-04,Central,743,614,129,523,91,112,94,18,56,38,Greater MN,2022-07-14
2021-10-04,Metro,3893,3684,209,3387,297,849,742,107,630,112,Metro,2022-07-14
2021-10-04,Northeast,934,508,426,431,77,108,70,38,50,20,Greater MN,2022-07-14
2021-10-04,Northwest,334,162,172,134,28,31,17,14,5,12,Greater MN,2022-07-14
2021-10-04,South Central,372,231,141,190,41,22,11,11,4,7,Greater MN,2022-07-14
2021-10-04,Southeast,1306,1028,278,969,59,252,196,56,172,24,Greater MN,2022-07-14
2021-10-04,Southwest,365,125,240,110,15,14,6,8,2,4,Greater MN,2022-07-14
2021-10-04,State,8155,6458,1697,5833,625,1408,1144,264,924,220,State,2022-07-14
2021-10-04,West Central,208,106,102,89,17,20,8,12,5,3,Greater MN,2022-07-14
2020-10-05,Central,942,573,369,538,35,162,98,64,81,17,Greater MN,2022-07-14
2020-10-05,Metro,4572,3742,830,3592,150,796,643,153,562,81,Metro,2022-07-14
2020-10-05,Northeast,1176,605,571,585,20,144,78,66,70,8,Greater MN,2022-07-14
2020-10-05,Northwest,339,162,177,146,16,32,14,18,10,4,Greater MN,2022-07-14
2020-10-05,South Central,573,185,388,173,12,21,7,14,5,2,Greater MN,2022-07-14
2020-10-05,Southeast,1416,889,527,863,26,251,127,124,116,11,Greater MN,2022-07-14
2020-10-05,Southwest,468,111,357,100,11,21,2,19,1,1,Greater MN,2022-07-14
2020-10-05,State,9694,6328,3366,6055,273,1447,975,472,851,124,State,2022-07-14
2020-10-05,West Central,208,61,147,58,3,20,6,14,6,0,Greater MN,2022-07-14
2021-10-05,Central,796,678,118,571,107,111,95,16,55,40,Greater MN,2022-07-14
2021-10-05,Metro,4032,3805,227,3507,298,866,765,101,654,111,Metro,2022-07-14
2021-10-05,Northeast,945,558,387,485,73,112,82,30,60,22,Greater MN,2022-07-14
2021-10-05,Northwest,334,167,167,141,26,31,15,16,5,10,Greater MN,2022-07-14
2021-10-05,South Central,371,239,132,198,41,23,12,11,2,10,Greater MN,2022-07-14
2021-10-05,Southeast,1311,1102,209,1047,55,253,201,52,177,24,Greater MN,2022-07-14
2021-10-05,Southwest,380,156,224,135,21,11,6,5,1,5,Greater MN,2022-07-14
2021-10-05,State,8377,6828,1549,6188,640,1427,1184,243,960,224,State,2022-07-14
2021-10-05,West Central,208,123,85,104,19,20,8,12,6,2,Greater MN,2022-07-14
2020-10-06,Central,950,617,333,581,36,164,104,60,85,19,Greater MN,2022-07-14
2020-10-06,Metro,4711,4039,672,3881,158,835,683,152,595,88,Metro,2022-07-14
2020-10-06,Northeast,1176,615,561,588,27,145,94,51,84,10,Greater MN,2022-07-14
2020-10-06,Northwest,348,171,177,151,20,32,17,15,13,4,Greater MN,2022-07-14
2020-10-06,South Central,573,215,358,203,12,21,8,13,5,3,Greater MN,2022-07-14
2020-10-06,Southeast,1418,952,466,929,23,251,148,103,137,11,Greater MN,2022-07-14
2020-10-06,Southwest,467,139,328,127,12,21,2,19,2,0,Greater MN,2022-07-14
2020-10-06,State,9851,6839,3012,6550,289,1489,1060,429,925,135,State,2022-07-14
2020-10-06,West Central,208,91,117,90,1,20,4,16,4,0,Greater MN,2022-07-14
2021-10-06,Central,812,686,126,582,104,115,100,15,57,43,Greater MN,2022-07-14
2021-10-06,Metro,4287,4044,243,3746,298,857,754,103,635,119,Metro,2022-07-14
2021-10-06,Northeast,957,575,382,501,74,112,82,30,59,23,Greater MN,2022-07-14
2021-10-06,Northwest,344,175,169,151,24,27,16,11,6,10,Greater MN,2022-07-14
2021-10-06,South Central,372,238,134,191,47,23,13,10,2,11,Greater MN,2022-07-14
2021-10-06,Southeast,1324,1130,194,1069,61,253,211,42,186,25,Greater MN,2022-07-14
2021-10-06,Southwest,401,174,227,151,23,12,5,7,3,2,Greater MN,2022-07-14
2021-10-06,State,8737,7166,1571,6515,651,1419,1189,230,955,234,State,2022-07-14
2021-10-06,West Central,240,144,96,124,20,20,8,12,7,1,Greater MN,2022-07-14
2020-10-07,Central,908,636,272,592,44,159,103,56,88,15,Greater MN,2022-07-14
2020-10-07,Metro,4824,4072,752,3903,169,828,705,123,612,93,Metro,2022-07-14
2020-10-07,Northeast,1172,618,554,596,22,144,92,52,80,12,Greater MN,2022-07-14
2020-10-07,Northwest,348,176,172,155,21,32,20,12,16,4,Greater MN,2022-07-14
2020-10-07,South Central,577,221,356,209,12,21,6,15,3,3,Greater MN,2022-07-14
2020-10-07,Southeast,1436,993,443,961,32,251,143,108,133,10,Greater MN,2022-07-14
2020-10-07,Southwest,482,144,338,131,13,21,3,18,3,0,Greater MN,2022-07-14
2020-10-07,State,9955,6962,2993,6647,315,1476,1078,398,941,137,State,2022-07-14
2020-10-07,West Central,208,102,106,100,2,20,6,14,6,0,Greater MN,2022-07-14
2021-10-07,Central,786,660,126,556,104,112,95,17,53,42,Greater MN,2022-07-14
2021-10-07,Metro,4051,3816,235,3502,314,840,740,100,621,119,Metro,2022-07-14
2021-10-07,Northeast,957,546,411,482,64,112,79,33,54,25,Greater MN,2022-07-14
2021-10-07,Northwest,335,180,155,154,26,31,17,14,5,12,Greater MN,2022-07-14
2021-10-07,South Central,365,242,123,205,37,24,11,13,2,9,Greater MN,2022-07-14
2021-10-07,Southeast,1315,1129,186,1081,48,254,196,58,171,25,Greater MN,2022-07-14
2021-10-07,Southwest,378,153,225,128,25,14,9,5,6,3,Greater MN,2022-07-14
2021-10-07,State,8395,6844,1551,6207,637,1407,1154,253,918,236,State,2022-07-14
2021-10-07,West Central,208,118,90,99,19,20,7,13,6,1,Greater MN,2022-07-14
2020-10-08,Central,942,612,330,564,48,165,110,55,92,18,Greater MN,2022-07-14
2020-10-08,Metro,4799,4060,739,3877,183,841,700,141,619,81,Metro,2022-07-14
2020-10-08,Northeast,1170,627,543,598,29,146,85,61,76,9,Greater MN,2022-07-14
2020-10-08,Northwest,348,171,177,153,18,32,14,18,9,5,Greater MN,2022-07-14
2020-10-08,South Central,578,226,352,213,13,21,12,9,7,5,Greater MN,2022-07-14
2020-10-08,Southeast,1453,1034,419,1002,32,251,160,91,148,12,Greater MN,2022-07-14
2020-10-08,Southwest,483,144,339,133,11,21,3,18,3,0,Greater MN,2022-07-14
2020-10-08,State,9981,6965,3016,6631,334,1497,1090,407,959,131,State,2022-07-14
2020-10-08,West Central,208,91,117,91,0,20,6,14,5,1,Greater MN,2022-07-14
2021-10-08,Central,797,687,110,575,112,110,94,16,55,39,Greater MN,2022-07-14
2021-10-08,Metro,4084,3881,203,3553,328,825,745,80,622,123,Metro,2022-07-14
2021-10-08,Northeast,962,544,418,470,74,112,74,38,53,21,Greater MN,2022-07-14
2021-10-08,Northwest,335,168,167,136,32,31,15,16,3,12,Greater MN,2022-07-14
2021-10-08,South Central,374,267,107,222,45,23,11,12,3,8,Greater MN,2022-07-14
2021-10-08,Southeast,1311,1103,208,1055,48,252,205,47,176,29,Greater MN,2022-07-14
2021-10-08,Southwest,370,145,225,121,24,11,7,4,2,5,Greater MN,2022-07-14
2021-10-08,State,8441,6909,1532,6231,678,1384,1157,227,919,238,State,2022-07-14
2021-10-08,West Central,208,114,94,99,15,20,6,14,5,1,Greater MN,2022-07-14
2020-10-09,Central,935,616,319,570,46,165,102,63,84,18,Greater MN,2022-07-14
2020-10-09,Metro,4804,4059,745,3893,166,835,731,104,646,85,Metro,2022-07-14
2020-10-09,Northeast,1181,629,552,600,29,145,85,60,74,11,Greater MN,2022-07-14
2020-10-09,Northwest,348,173,175,154,19,32,18,14,9,9,Greater MN,2022-07-14
2020-10-09,South Central,574,226,348,211,15,22,12,10,8,4,Greater MN,2022-07-14
2020-10-09,Southeast,1447,1053,394,1026,27,251,156,95,142,14,Greater MN,2022-07-14
2020-10-09,Southwest,481,137,344,124,13,21,4,17,4,0,Greater MN,2022-07-14
2020-10-09,State,9978,6974,3004,6656,318,1491,1113,378,971,142,State,2022-07-14
2020-10-09,West Central,208,81,127,78,3,20,5,15,4,1,Greater MN,2022-07-14
2021-10-09,Central,767,658,109,549,109,101,84,17,50,34,Greater MN,2022-07-14
2021-10-09,Metro,3983,3788,195,3472,316,822,739,83,611,128,Metro,2022-07-14
2021-10-09,Northeast,958,522,436,449,73,114,73,41,50,23,Greater MN,2022-07-14
2021-10-09,Northwest,335,181,154,145,36,31,14,17,2,12,Greater MN,2022-07-14
2021-10-09,South Central,372,252,120,209,43,24,12,12,4,8,Greater MN,2022-07-14
2021-10-09,Southeast,1316,1097,219,1044,53,251,198,53,168,30,Greater MN,2022-07-14
2021-10-09,Southwest,369,143,226,118,25,10,6,4,3,3,Greater MN,2022-07-14
2021-10-09,State,8308,6749,1559,6076,673,1373,1132,241,893,239,State,2022-07-14
2021-10-09,West Central,208,108,100,90,18,20,6,14,5,1,Greater MN,2022-07-14
2020-10-10,Central,935,610,325,562,48,165,94,71,74,20,Greater MN,2022-07-14
2020-10-10,Metro,4736,3993,743,3829,164,817,718,99,640,78,Metro,2022-07-14
2020-10-10,Northeast,1180,580,600,557,23,144,89,55,77,12,Greater MN,2022-07-14
2020-10-10,Northwest,347,157,190,139,18,33,18,15,10,8,Greater MN,2022-07-14
2020-10-10,South Central,573,201,372,186,15,23,10,13,8,2,Greater MN,2022-07-14
2020-10-10,Southeast,1421,1007,414,986,21,251,155,96,141,14,Greater MN,2022-07-14
2020-10-10,Southwest,483,123,360,106,17,21,2,19,2,0,Greater MN,2022-07-14
2020-10-10,State,9883,6748,3135,6439,309,1474,1092,382,958,134,State,2022-07-14
2020-10-10,West Central,208,77,131,74,3,20,6,14,6,0,Greater MN,2022-07-14
2021-10-10,Central,757,630,127,518,112,111,93,18,57,36,Greater MN,2022-07-14
2021-10-10,Metro,3894,3677,217,3366,311,826,715,111,581,134,Metro,2022-07-14
2021-10-10,Northeast,952,528,424,446,82,114,73,41,51,22,Greater MN,2022-07-14
2021-10-10,Northwest,335,167,168,131,36,31,16,15,3,13,Greater MN,2022-07-14
2021-10-10,South Central,372,248,124,201,47,24,12,12,5,7,Greater MN,2022-07-14
2021-10-10,Southeast,1313,1024,289,964,60,253,186,67,159,27,Greater MN,2022-07-14
2021-10-10,Southwest,370,155,215,131,24,13,7,6,3,4,Greater MN,2022-07-14
2021-10-10,State,8201,6521,1680,5832,689,1392,1110,282,866,244,State,2022-07-14
2021-10-10,West Central,208,92,116,75,17,20,8,12,7,1,Greater MN,2022-07-14
2020-10-11,Central,936,560,376,511,49,165,88,77,66,22,Greater MN,2022-07-14
2020-10-11,Metro,4624,3772,852,3599,173,811,706,105,620,86,Metro,2022-07-14
2020-10-11,Northeast,1180,588,592,561,27,145,82,63,71,11,Greater MN,2022-07-14
2020-10-11,Northwest,348,143,205,127,16,32,18,14,10,8,Greater MN,2022-07-14
2020-10-11,South Central,575,199,376,186,13,21,8,13,6,2,Greater MN,2022-07-14
2020-10-11,Southeast,1421,927,494,905,22,251,128,123,114,14,Greater MN,2022-07-14
2020-10-11,Southwest,484,117,367,100,17,21,1,20,1,0,Greater MN,2022-07-14
2020-10-11,State,9776,6380,3396,6059,321,1466,1034,432,891,143,State,2022-07-14
2020-10-11,West Central,208,74,134,70,4,20,3,17,3,0,Greater MN,2022-07-14
2021-10-11,Central,760,639,121,533,106,110,98,12,55,43,Greater MN,2022-07-14
2021-10-11,Metro,3888,3682,206,3359,323,825,723,102,589,134,Metro,2022-07-14
2021-10-11,Northeast,953,533,420,449,84,113,74,39,49,25,Greater MN,2022-07-14
2021-10-11,Northwest,335,174,161,137,37,31,16,15,4,12,Greater MN,2022-07-14
2021-10-11,South Central,374,252,122,196,56,25,14,11,7,7,Greater MN,2022-07-14
2021-10-11,Southeast,1299,1021,278,965,56,249,176,73,149,27,Greater MN,2022-07-14
2021-10-11,Southwest,368,151,217,126,25,13,8,5,3,5,Greater MN,2022-07-14
2021-10-11,State,8185,6557,1628,5851,706,1386,1117,269,863,254,State,2022-07-14
2021-10-11,West Central,208,105,103,86,19,20,8,12,7,1,Greater MN,2022-07-14
2020-10-12,Central,940,581,359,533,48,165,94,71,76,18,Greater MN,2022-07-14
2020-10-12,Metro,4591,3781,810,3592,189,804,689,115,607,82,Metro,2022-07-14
2020-10-12,Northeast,1177,608,569,581,27,147,80,67,69,11,Greater MN,2022-07-14
2020-10-12,Northwest,348,154,194,136,18,32,14,18,7,7,Greater MN,2022-07-14
2020-10-12,South Central,575,211,364,200,11,21,11,10,9,2,Greater MN,2022-07-14
2020-10-12,Southeast,1422,894,528,867,27,251,130,121,119,11,Greater MN,2022-07-14
2020-10-12,Southwest,483,122,361,103,19,21,0,21,0,0,Greater MN,2022-07-14
2020-10-12,State,9744,6444,3300,6102,342,1461,1024,437,892,132,State,2022-07-14
2020-10-12,West Central,208,93,115,90,3,20,6,14,5,1,Greater MN,2022-07-14
2021-10-12,Central,758,657,101,534,123,123,110,13,65,45,Greater MN,2022-07-14
2021-10-12,Metro,4042,3848,194,3510,338,836,742,94,609,133,Metro,2022-07-14
2021-10-12,Northeast,968,540,428,456,84,113,80,33,50,30,Greater MN,2022-07-14
2021-10-12,Northwest,334,183,151,151,32,31,16,15,4,12,Greater MN,2022-07-14
2021-10-12,South Central,376,250,126,198,52,23,10,13,3,7,Greater MN,2022-07-14
2021-10-12,Southeast,1327,1120,207,1062,58,251,182,69,156,26,Greater MN,2022-07-14
2021-10-12,Southwest,368,156,212,130,26,11,7,4,2,5,Greater MN,2022-07-14
2021-10-12,State,8381,6878,1503,6145,733,1408,1153,255,894,259,State,2022-07-14
2021-10-12,West Central,208,124,84,104,20,20,6,14,5,1,Greater MN,2022-07-14
2020-10-13,Central,939,635,304,592,43,165,87,78,69,18,Greater MN,2022-07-14
2020-10-13,Metro,4782,4148,634,3947,201,817,702,115,617,85,Metro,2022-07-14
2020-10-13,Northeast,1179,626,553,599,27,144,80,64,70,10,Greater MN,2022-07-14
2020-10-13,Northwest,348,179,169,161,18,32,18,14,10,8,Greater MN,2022-07-14
2020-10-13,South Central,573,209,364,199,10,23,11,12,10,1,Greater MN,2022-07-14
2020-10-13,Southeast,1425,966,459,939,27,251,139,112,129,10,Greater MN,2022-07-14
2020-10-13,Southwest,483,136,347,119,17,21,1,20,1,0,Greater MN,2022-07-14
2020-10-13,State,9937,7005,2932,6659,346,1473,1045,428,912,133,State,2022-07-14
2020-10-13,West Central,208,106,102,103,3,20,7,13,6,1,Greater MN,2022-07-14
2021-10-13,Central,810,715,95,587,128,117,103,14,60,43,Greater MN,2022-07-14
2021-10-13,Metro,4216,3974,242,3637,337,847,751,96,609,142,Metro,2022-07-14
2021-10-13,Northeast,952,561,391,476,85,112,76,36,51,25,Greater MN,2022-07-14
2021-10-13,Northwest,350,200,150,169,31,31,15,16,7,8,Greater MN,2022-07-14
2021-10-13,South Central,374,253,121,208,45,23,11,12,2,9,Greater MN,2022-07-14
2021-10-13,Southeast,1333,1119,214,1060,59,254,189,65,167,22,Greater MN,2022-07-14
2021-10-13,Southwest,391,167,224,141,26,10,6,4,1,5,Greater MN,2022-07-14
2021-10-13,State,8666,7129,1537,6400,729,1414,1155,259,900,255,State,2022-07-14
2021-10-13,West Central,240,140,100,122,18,20,4,16,3,1,Greater MN,2022-07-14
2020-10-14,Central,945,628,317,589,39,165,86,79,66,20,Greater MN,2022-07-14
2020-10-14,Metro,4414,3759,655,3581,178,736,651,85,580,71,Metro,2022-07-14
2020-10-14,Northeast,1179,657,522,624,33,144,76,68,68,8,Greater MN,2022-07-14
2020-10-14,Northwest,340,185,155,171,14,32,17,15,12,5,Greater MN,2022-07-14
2020-10-14,South Central,573,203,370,193,10,23,11,12,10,1,Greater MN,2022-07-14
2020-10-14,Southeast,1426,986,440,959,27,251,140,111,132,8,Greater MN,2022-07-14
2020-10-14,Southwest,484,144,340,125,19,21,4,17,4,0,Greater MN,2022-07-14
2020-10-14,State,9569,6664,2905,6341,323,1392,993,399,879,114,State,2022-07-14
2020-10-14,West Central,208,102,106,99,3,20,8,12,7,1,Greater MN,2022-07-14
2021-10-14,Central,766,657,109,534,123,120,109,11,61,48,Greater MN,2022-07-14
2021-10-14,Metro,4020,3848,172,3490,358,849,746,103,613,133,Metro,2022-07-14
2021-10-14,Northeast,962,566,396,483,83,112,75,37,55,20,Greater MN,2022-07-14
2021-10-14,Northwest,334,193,141,158,35,31,16,15,5,11,Greater MN,2022-07-14
2021-10-14,South Central,373,248,125,205,43,23,13,10,3,10,Greater MN,2022-07-14
2021-10-14,Southeast,1316,1097,219,1042,55,258,207,51,183,24,Greater MN,2022-07-14
2021-10-14,Southwest,378,159,219,123,36,14,10,4,4,6,Greater MN,2022-07-14
2021-10-14,State,8357,6865,1492,6117,748,1427,1178,249,925,253,State,2022-07-14
2021-10-14,West Central,208,97,111,82,15,20,2,18,1,1,Greater MN,2022-07-14
2020-10-15,Central,944,594,350,552,42,165,92,73,73,19,Greater MN,2022-07-14
2020-10-15,Metro,4842,4166,676,3968,198,834,719,115,634,85,Metro,2022-07-14
2020-10-15,Northeast,1172,622,550,584,38,145,78,67,76,2,Greater MN,2022-07-14
2020-10-15,Northwest,348,176,172,162,14,32,15,17,12,3,Greater MN,2022-07-14
2020-10-15,South Central,573,214,359,204,10,23,12,11,11,1,Greater MN,2022-07-14
2020-10-15,Southeast,1421,992,429,960,32,251,147,104,138,9,Greater MN,2022-07-14
2020-10-15,Southwest,484,154,330,135,19,21,2,19,2,0,Greater MN,2022-07-14
2020-10-15,State,9992,7022,2970,6665,357,1491,1071,420,952,119,State,2022-07-14
2020-10-15,West Central,208,104,104,100,4,20,6,14,6,0,Greater MN,2022-07-14
2021-10-15,Central,759,650,109,527,123,116,105,11,56,49,Greater MN,2022-07-14
2021-10-15,Metro,4030,3840,190,3450,390,844,761,83,631,130,Metro,2022-07-14
2021-10-15,Northeast,969,549,420,465,84,112,74,38,59,15,Greater MN,2022-07-14
2021-10-15,Northwest,334,175,159,141,34,31,17,14,5,12,Greater MN,2022-07-14
2021-10-15,South Central,375,248,127,206,42,23,11,12,3,8,Greater MN,2022-07-14
2021-10-15,Southeast,1309,1087,222,1049,38,253,203,50,177,26,Greater MN,2022-07-14
2021-10-15,Southwest,375,168,207,135,33,13,9,4,4,5,Greater MN,2022-07-14
2021-10-15,State,8359,6832,1527,6070,762,1412,1184,228,938,246,State,2022-07-14
2021-10-15,West Central,208,115,93,97,18,20,4,16,3,1,Greater MN,2022-07-14
2020-10-16,Central,945,596,349,547,49,165,101,64,81,20,Greater MN,2022-07-14
2020-10-16,Metro,4728,4001,727,3800,201,832,728,104,634,94,Metro,2022-07-14
2020-10-16,Northeast,1169,615,554,587,28,148,81,67,70,11,Greater MN,2022-07-14
2020-10-16,Northwest,348,173,175,157,16,32,15,17,10,5,Greater MN,2022-07-14
2020-10-16,South Central,574,203,371,195,8,22,9,13,8,1,Greater MN,2022-07-14
2020-10-16,Southeast,1423,973,450,942,31,251,140,111,132,8,Greater MN,2022-07-14
2020-10-16,Southwest,485,143,342,124,19,21,2,19,2,0,Greater MN,2022-07-14
2020-10-16,State,9880,6786,3094,6431,355,1491,1080,411,941,139,State,2022-07-14
2020-10-16,West Central,208,82,126,79,3,20,4,16,4,0,Greater MN,2022-07-14
2021-10-16,Central,749,637,112,524,113,116,104,12,56,48,Greater MN,2022-07-14
2021-10-16,Metro,3950,3772,178,3424,348,843,734,109,603,131,Metro,2022-07-14
2021-10-16,Northeast,932,534,398,462,72,107,75,32,56,19,Greater MN,2022-07-14
2021-10-16,Northwest,334,165,169,127,38,31,17,14,4,13,Greater MN,2022-07-14
2021-10-16,South Central,371,224,147,186,38,23,13,10,4,9,Greater MN,2022-07-14
2021-10-16,Southeast,1311,1111,200,1065,46,250,200,50,174,26,Greater MN,2022-07-14
2021-10-16,Southwest,368,160,208,129,31,10,6,4,1,5,Greater MN,2022-07-14
2021-10-16,State,8223,6713,1510,6007,706,1400,1155,245,901,254,State,2022-07-14
2021-10-16,West Central,208,110,98,90,20,20,6,14,3,3,Greater MN,2022-07-14
2020-10-17,Central,945,578,367,535,43,165,98,67,75,23,Greater MN,2022-07-14
2020-10-17,Metro,4609,3744,865,3533,211,835,719,116,631,88,Metro,2022-07-14
2020-10-17,Northeast,1168,593,575,569,24,147,82,65,68,14,Greater MN,2022-07-14
2020-10-17,Northwest,348,173,175,155,18,32,19,13,15,4,Greater MN,2022-07-14
2020-10-17,South Central,575,200,375,192,8,21,5,16,4,1,Greater MN,2022-07-14
2020-10-17,Southeast,1426,961,465,930,31,251,148,103,141,7,Greater MN,2022-07-14
2020-10-17,Southwest,484,142,342,122,20,21,1,20,1,0,Greater MN,2022-07-14
2020-10-17,State,9763,6460,3303,6101,359,1492,1077,415,940,137,State,2022-07-14
2020-10-17,West Central,208,69,139,65,4,20,5,15,5,0,Greater MN,2022-07-14
2021-10-17,Central,742,619,123,507,112,104,92,12,43,49,Greater MN,2022-07-14
2021-10-17,Metro,3844,3596,248,3264,332,852,736,116,605,131,Metro,2022-07-14
2021-10-17,Northeast,943,534,409,460,74,109,78,31,57,21,Greater MN,2022-07-14
2021-10-17,Northwest,334,158,176,116,42,31,18,13,6,12,Greater MN,2022-07-14
2021-10-17,South Central,373,233,140,193,40,22,8,14,2,6,Greater MN,2022-07-14
2021-10-17,Southeast,1308,1044,264,1003,41,251,187,64,158,29,Greater MN,2022-07-14
2021-10-17,Southwest,364,147,217,122,25,9,5,4,1,4,Greater MN,2022-07-14
2021-10-17,State,8116,6431,1685,5744,687,1398,1128,270,873,255,State,2022-07-14
2021-10-17,West Central,208,100,108,79,21,20,4,16,1,3,Greater MN,2022-07-14
2020-10-18,Central,947,556,391,505,51,165,93,72,70,23,Greater MN,2022-07-14
2020-10-18,Metro,4524,3641,883,3422,219,824,699,125,614,85,Metro,2022-07-14
2020-10-18,Northeast,1168,588,580,557,31,149,85,64,72,13,Greater MN,2022-07-14
2020-10-18,Northwest,348,159,189,144,15,32,20,12,16,4,Greater MN,2022-07-14
2020-10-18,South Central,575,196,379,186,10,21,8,13,7,1,Greater MN,2022-07-14
2020-10-18,Southeast,1421,891,530,856,35,251,123,128,114,9,Greater MN,2022-07-14
2020-10-18,Southwest,484,150,334,127,23,21,0,21,0,0,Greater MN,2022-07-14
2020-10-18,State,9675,6240,3435,5853,387,1483,1032,451,896,136,State,2022-07-14
2020-10-18,West Central,208,59,149,56,3,20,4,16,3,1,Greater MN,2022-07-14
2021-10-18,Central,728,605,123,487,118,114,103,11,55,48,Greater MN,2022-07-14
2021-10-18,Metro,3852,3639,213,3303,336,856,725,131,597,128,Metro,2022-07-14
2021-10-18,Northeast,924,518,406,447,71,114,67,47,50,17,Greater MN,2022-07-14
2021-10-18,Northwest,335,170,165,127,43,31,17,14,4,13,Greater MN,2022-07-14
2021-10-18,South Central,372,244,128,200,44,22,11,11,5,6,Greater MN,2022-07-14
2021-10-18,Southeast,1302,1017,285,973,44,245,178,67,151,27,Greater MN,2022-07-14
2021-10-18,Southwest,372,159,213,130,29,11,6,5,1,5,Greater MN,2022-07-14
2021-10-18,State,8092,6445,1647,5741,704,1413,1113,300,867,246,State,2022-07-14
2021-10-18,West Central,207,93,114,74,19,20,6,14,4,2,Greater MN,2022-07-14
2020-10-19,Central,949,567,382,511,56,165,96,69,71,25,Greater MN,2022-07-14
2020-10-19,Metro,4433,3526,907,3308,218,840,700,140,602,98,Metro,2022-07-14
2020-10-19,Northeast,1170,614,556,577,37,148,90,58,79,11,Greater MN,2022-07-14
2020-10-19,Northwest,342,158,184,145,13,32,18,14,13,5,Greater MN,2022-07-14
2020-10-19,South Central,575,194,381,185,9,21,8,13,6,2,Greater MN,2022-07-14
2020-10-19,Southeast,1418,867,551,836,31,251,121,130,110,11,Greater MN,2022-07-14
2020-10-19,Southwest,484,163,321,134,29,21,0,21,0,0,Greater MN,2022-07-14
2020-10-19,State,9579,6161,3418,5762,399,1498,1038,460,885,153,State,2022-07-14
2020-10-19,West Central,208,72,136,66,6,20,5,15,4,1,Greater MN,2022-07-14
2021-10-19,Central,740,632,108,505,127,117,104,13,60,44,Greater MN,2022-07-14
2021-10-19,Metro,3969,3766,203,3429,337,865,756,109,625,131,Metro,2022-07-14
2021-10-19,Northeast,914,535,379,464,71,114,63,51,46,17,Greater MN,2022-07-14
2021-10-19,Northwest,335,186,149,149,37,31,16,15,4,12,Greater MN,2022-07-14
2021-10-19,South Central,375,250,125,206,44,22,10,12,4,6,Greater MN,2022-07-14
2021-10-19,Southeast,1312,1075,237,1029,46,250,194,56,167,27,Greater MN,2022-07-14
2021-10-19,Southwest,372,167,205,141,26,15,3,12,1,2,Greater MN,2022-07-14
2021-10-19,State,8224,6727,1497,6020,707,1434,1152,282,912,240,State,2022-07-14
2021-10-19,West Central,207,116,91,97,19,20,6,14,5,1,Greater MN,2022-07-14
2020-10-20,Central,951,593,358,540,53,165,98,67,71,27,Greater MN,2022-07-14
2020-10-20,Metro,4630,3838,792,3607,231,849,725,124,626,99,Metro,2022-07-14
2020-10-20,Northeast,1163,618,545,583,35,149,86,63,77,9,Greater MN,2022-07-14
2020-10-20,Northwest,348,168,180,156,12,32,18,14,12,6,Greater MN,2022-07-14
2020-10-20,South Central,578,216,362,207,9,18,10,8,8,2,Greater MN,2022-07-14
2020-10-20,Southeast,1425,940,485,910,30,251,146,105,131,15,Greater MN,2022-07-14
2020-10-20,Southwest,485,155,330,125,30,21,1,20,1,0,Greater MN,2022-07-14
2020-10-20,State,9788,6633,3155,6222,411,1505,1090,415,932,158,State,2022-07-14
2020-10-20,West Central,208,105,103,94,11,20,6,14,6,0,Greater MN,2022-07-14
2021-10-20,Central,793,669,124,561,108,118,110,8,64,46,Greater MN,2022-07-14
2021-10-20,Metro,4214,4010,204,3659,351,857,747,110,618,129,Metro,2022-07-14
2021-10-20,Northeast,929,553,376,482,71,114,73,41,54,19,Greater MN,2022-07-14
2021-10-20,Northwest,350,206,144,174,32,31,17,14,6,11,Greater MN,2022-07-14
2021-10-20,South Central,379,242,137,205,37,22,9,13,4,5,Greater MN,2022-07-14
2021-10-20,Southeast,1316,1156,160,1109,47,253,203,50,171,32,Greater MN,2022-07-14
2021-10-20,Southwest,387,159,228,129,30,11,5,6,3,2,Greater MN,2022-07-14
2021-10-20,State,8607,7134,1473,6437,697,1426,1172,254,927,245,State,2022-07-14
2021-10-20,West Central,239,139,100,118,21,20,8,12,7,1,Greater MN,2022-07-14
2020-10-21,Central,946,600,346,540,60,165,99,66,73,26,Greater MN,2022-07-14
2020-10-21,Metro,4814,4084,730,3852,232,838,704,134,605,99,Metro,2022-07-14
2020-10-21,Northeast,1175,644,531,610,34,143,83,60,76,7,Greater MN,2022-07-14
2020-10-21,Northwest,348,170,178,159,11,32,16,16,10,6,Greater MN,2022-07-14
2020-10-21,South Central,574,219,355,208,11,22,10,12,8,2,Greater MN,2022-07-14
2020-10-21,Southeast,1442,998,444,964,34,251,145,106,131,14,Greater MN,2022-07-14
2020-10-21,Southwest,485,150,335,125,25,21,2,19,2,0,Greater MN,2022-07-14
2020-10-21,State,9992,6980,3012,6563,417,1492,1065,427,911,154,State,2022-07-14
2020-10-21,West Central,208,115,93,105,10,20,6,14,6,0,Greater MN,2022-07-14
2021-10-21,Central,755,626,129,509,117,109,97,12,60,37,Greater MN,2022-07-14
2021-10-21,Metro,4048,3872,176,3532,340,854,749,105,629,120,Metro,2022-07-14
2021-10-21,Northeast,945,553,392,478,75,114,69,45,50,19,Greater MN,2022-07-14
2021-10-21,Northwest,334,187,147,161,26,31,21,10,9,12,Greater MN,2022-07-14
2021-10-21,South Central,382,261,121,227,34,22,10,12,5,5,Greater MN,2022-07-14
2021-10-21,Southeast,1301,1117,184,1061,56,253,199,54,172,27,Greater MN,2022-07-14
2021-10-21,Southwest,369,154,215,129,25,11,4,7,3,1,Greater MN,2022-07-14
2021-10-21,State,8341,6872,1469,6177,695,1414,1157,257,934,223,State,2022-07-14
2021-10-21,West Central,207,102,105,80,22,20,8,12,6,2,Greater MN,2022-07-14
2020-10-22,Central,940,590,350,531,59,166,95,71,72,23,Greater MN,2022-07-14
2020-10-22,Metro,4777,4068,709,3841,227,842,717,125,616,101,Metro,2022-07-14
2020-10-22,Northeast,1181,609,572,579,30,145,82,63,70,12,Greater MN,2022-07-14
2020-10-22,Northwest,348,176,172,161,15,32,16,16,8,8,Greater MN,2022-07-14
2020-10-22,South Central,574,207,367,199,8,22,11,11,10,1,Greater MN,2022-07-14
2020-10-22,Southeast,1437,1014,423,976,38,251,154,97,139,15,Greater MN,2022-07-14
2020-10-22,Southwest,483,163,320,137,26,21,1,20,0,1,Greater MN,2022-07-14
2020-10-22,State,9948,6929,3019,6518,411,1499,1081,418,920,161,State,2022-07-14
2020-10-22,West Central,208,102,106,94,8,20,5,15,5,0,Greater MN,2022-07-14
2021-10-22,Central,759,630,129,511,119,107,96,11,63,33,Greater MN,2022-07-14
2021-10-22,Metro,3974,3778,196,3454,324,850,752,98,626,126,Metro,2022-07-14
2021-10-22,Northeast,951,556,395,481,75,114,66,48,45,21,Greater MN,2022-07-14
2021-10-22,Northwest,334,174,160,151,23,31,18,13,7,11,Greater MN,2022-07-14
2021-10-22,South Central,377,233,144,197,36,22,11,11,6,5,Greater MN,2022-07-14
2021-10-22,Southeast,1302,1078,224,1027,51,250,192,58,166,26,Greater MN,2022-07-14
2021-10-22,Southwest,371,148,223,119,29,12,1,11,0,1,Greater MN,2022-07-14
2021-10-22,State,8275,6694,1581,6014,680,1406,1144,262,917,227,State,2022-07-14
2021-10-22,West Central,207,97,110,74,23,20,8,12,4,4,Greater MN,2022-07-14
2020-10-23,Central,929,583,346,524,59,166,94,72,70,24,Greater MN,2022-07-14
2020-10-23,Metro,4818,4081,737,3855,226,834,726,108,625,101,Metro,2022-07-14
2020-10-23,Northeast,1176,633,543,594,39,147,78,69,69,9,Greater MN,2022-07-14
2020-10-23,Northwest,348,166,182,144,22,32,15,17,11,4,Greater MN,2022-07-14
2020-10-23,South Central,574,202,372,193,9,22,8,14,7,1,Greater MN,2022-07-14
2020-10-23,Southeast,1428,1030,398,997,33,251,149,102,139,10,Greater MN,2022-07-14
2020-10-23,Southwest,483,165,318,135,30,21,3,18,1,2,Greater MN,2022-07-14
2020-10-23,State,9964,6945,3019,6520,425,1493,1078,415,927,151,State,2022-07-14
2020-10-23,West Central,208,85,123,78,7,20,5,15,5,0,Greater MN,2022-07-14
2021-10-23,Central,761,626,135,496,130,98,85,13,56,29,Greater MN,2022-07-14
2021-10-23,Metro,3956,3689,267,3363,326,842,735,107,610,125,Metro,2022-07-14
2021-10-23,Northeast,947,525,422,451,74,114,68,46,46,22,Greater MN,2022-07-14
2021-10-23,Northwest,334,158,176,135,23,31,19,12,9,10,Greater MN,2022-07-14
2021-10-23,South Central,371,227,144,190,37,22,11,11,8,3,Greater MN,2022-07-14
2021-10-23,Southeast,1303,1040,263,985,55,253,202,51,177,25,Greater MN,2022-07-14
2021-10-23,Southwest,370,144,226,115,29,11,1,10,0,1,Greater MN,2022-07-14
2021-10-23,State,8250,6502,1748,5812,690,1391,1128,263,909,219,State,2022-07-14
2021-10-23,West Central,208,93,115,77,16,20,7,13,3,4,Greater MN,2022-07-14
2020-10-24,Central,916,565,351,505,60,165,93,72,70,23,Greater MN,2022-07-14
2020-10-24,Metro,4494,3934,560,3692,242,835,722,113,630,92,Metro,2022-07-14
2020-10-24,Northeast,1174,580,594,544,36,149,79,70,69,10,Greater MN,2022-07-14
2020-10-24,Northwest,348,157,191,134,23,32,17,15,12,5,Greater MN,2022-07-14
2020-10-24,South Central,543,182,361,175,7,22,9,13,8,1,Greater MN,2022-07-14
2020-10-24,Southeast,1433,1021,412,983,38,251,151,100,143,8,Greater MN,2022-07-14
2020-10-24,Southwest,484,139,345,113,26,21,2,19,1,1,Greater MN,2022-07-14
2020-10-24,State,9600,6648,2952,6208,440,1495,1076,419,936,140,State,2022-07-14
2020-10-24,West Central,208,70,138,62,8,20,3,17,3,0,Greater MN,2022-07-14
2021-10-24,Central,752,610,142,484,126,102,86,16,58,28,Greater MN,2022-07-14
2021-10-24,Metro,3906,3611,295,3279,332,836,718,118,594,124,Metro,2022-07-14
2021-10-24,Northeast,944,542,402,468,74,114,67,47,45,22,Greater MN,2022-07-14
2021-10-24,Northwest,334,147,187,121,26,31,17,14,8,9,Greater MN,2022-07-14
2021-10-24,South Central,375,231,144,192,39,22,10,12,7,3,Greater MN,2022-07-14
2021-10-24,Southeast,1304,978,326,912,66,253,194,59,168,26,Greater MN,2022-07-14
2021-10-24,Southwest,363,127,236,103,24,11,1,10,0,1,Greater MN,2022-07-14
2021-10-24,State,8186,6328,1858,5623,705,1389,1100,289,883,217,State,2022-07-14
2021-10-24,West Central,208,82,126,64,18,20,7,13,3,4,Greater MN,2022-07-14
2020-10-25,Central,939,519,420,453,66,165,91,74,64,27,Greater MN,2022-07-14
2020-10-25,Metro,4583,3819,764,3572,247,832,704,128,606,98,Metro,2022-07-14
2020-10-25,Northeast,1179,570,609,534,36,148,88,60,78,10,Greater MN,2022-07-14
2020-10-25,Northwest,329,162,167,139,23,31,14,17,10,4,Greater MN,2022-07-14
2020-10-25,South Central,574,173,401,168,5,22,10,12,9,1,Greater MN,2022-07-14
2020-10-25,Southeast,1435,930,505,891,39,251,121,130,115,6,Greater MN,2022-07-14
2020-10-25,Southwest,485,137,348,106,31,21,4,17,2,2,Greater MN,2022-07-14
2020-10-25,State,9732,6386,3346,5929,457,1490,1036,454,888,148,State,2022-07-14
2020-10-25,West Central,208,76,132,66,10,20,4,16,4,0,Greater MN,2022-07-14
2021-10-25,Central,758,617,141,489,128,106,89,17,58,31,Greater MN,2022-07-14
2021-10-25,Metro,3878,3597,281,3248,349,845,723,122,608,115,Metro,2022-07-14
2021-10-25,Northeast,948,547,401,475,72,111,66,45,43,23,Greater MN,2022-07-14
2021-10-25,Northwest,334,162,172,134,28,31,17,14,9,8,Greater MN,2022-07-14
2021-10-25,South Central,382,233,149,192,41,22,10,12,7,3,Greater MN,2022-07-14
2021-10-25,Southeast,1306,975,331,910,65,247,178,69,154,24,Greater MN,2022-07-14
2021-10-25,Southwest,365,129,236,102,27,10,3,7,1,2,Greater MN,2022-07-14
2021-10-25,State,8179,6344,1835,5617,727,1392,1094,298,884,210,State,2022-07-14
2021-10-25,West Central,208,84,124,67,17,20,8,12,4,4,Greater MN,2022-07-14
2020-10-26,Central,944,536,408,462,74,165,94,71,66,28,Greater MN,2022-07-14
2020-10-26,Metro,4572,3779,793,3513,266,830,681,149,570,111,Metro,2022-07-14
2020-10-26,Northeast,1177,588,589,550,38,147,80,67,70,10,Greater MN,2022-07-14
2020-10-26,Northwest,329,174,155,145,29,31,11,20,7,4,Greater MN,2022-07-14
2020-10-26,South Central,574,189,385,183,6,22,9,13,8,1,Greater MN,2022-07-14
2020-10-26,Southeast,1436,889,547,854,35,251,116,135,106,10,Greater MN,2022-07-14
2020-10-26,Southwest,485,148,337,116,32,21,2,19,0,2,Greater MN,2022-07-14
2020-10-26,State,9725,6370,3355,5880,490,1487,999,488,833,166,State,2022-07-14
2020-10-26,West Central,208,67,141,57,10,20,6,14,6,0,Greater MN,2022-07-14
2021-10-26,Central,771,651,120,535,116,107,93,14,59,34,Greater MN,2022-07-14
2021-10-26,Metro,4032,3781,251,3446,335,854,726,128,611,115,Metro,2022-07-14
2021-10-26,Northeast,948,542,406,482,60,111,74,37,51,23,Greater MN,2022-07-14
2021-10-26,Northwest,333,173,160,146,27,32,22,10,11,11,Greater MN,2022-07-14
2021-10-26,South Central,380,239,141,199,40,22,9,13,5,4,Greater MN,2022-07-14
2021-10-26,Southeast,1311,1057,254,995,62,255,189,66,163,26,Greater MN,2022-07-14
2021-10-26,Southwest,366,155,211,125,30,11,3,8,2,1,Greater MN,2022-07-14
2021-10-26,State,8349,6704,1645,6013,691,1412,1124,288,904,220,State,2022-07-14
2021-10-26,West Central,208,106,102,85,21,20,8,12,2,6,Greater MN,2022-07-14
2020-10-27,Central,943,599,344,522,77,166,99,67,70,29,Greater MN,2022-07-14
2020-10-27,Metro,4717,4047,670,3752,295,828,708,120,605,103,Metro,2022-07-14
2020-10-27,Northeast,1176,618,558,588,30,145,87,58,76,11,Greater MN,2022-07-14
2020-10-27,Northwest,329,179,150,152,27,31,15,16,9,6,Greater MN,2022-07-14
2020-10-27,South Central,574,208,366,197,11,22,9,13,8,1,Greater MN,2022-07-14
2020-10-27,Southeast,1429,954,475,923,31,251,147,104,136,11,Greater MN,2022-07-14
2020-10-27,Southwest,484,165,319,135,30,21,2,19,0,2,Greater MN,2022-07-14
2020-10-27,State,9860,6859,3001,6352,507,1484,1074,410,911,163,State,2022-07-14
2020-10-27,West Central,208,89,119,83,6,20,7,13,7,0,Greater MN,2022-07-14
2021-10-27,Central,808,703,105,575,128,110,97,13,63,34,Greater MN,2022-07-14
2021-10-27,Metro,4254,4017,237,3670,347,868,752,116,641,111,Metro,2022-07-14
2021-10-27,Northeast,940,561,379,505,56,114,78,36,57,21,Greater MN,2022-07-14
2021-10-27,Northwest,350,184,166,157,27,31,17,14,5,12,Greater MN,2022-07-14
2021-10-27,South Central,369,236,133,200,36,22,8,14,3,5,Greater MN,2022-07-14
2021-10-27,Southeast,1322,1145,177,1080,65,256,206,50,183,23,Greater MN,2022-07-14
2021-10-27,Southwest,380,156,224,126,30,11,5,6,4,1,Greater MN,2022-07-14
2021-10-27,State,8663,7149,1514,6436,713,1432,1172,260,960,212,State,2022-07-14
2021-10-27,West Central,240,147,93,123,24,20,9,11,4,5,Greater MN,2022-07-14
2020-10-28,Central,973,662,311,583,79,166,97,69,65,32,Greater MN,2022-07-14
2020-10-28,Metro,4943,4242,701,3932,310,866,736,130,628,108,Metro,2022-07-14
2020-10-28,Northeast,1174,609,565,580,29,144,89,55,77,12,Greater MN,2022-07-14
2020-10-28,Northwest,359,202,157,175,27,31,17,14,12,5,Greater MN,2022-07-14
2020-10-28,South Central,574,206,368,195,11,22,10,12,8,2,Greater MN,2022-07-14
2020-10-28,Southeast,1415,1003,412,969,34,251,159,92,146,13,Greater MN,2022-07-14
2020-10-28,Southwest,504,180,324,154,26,21,4,17,2,2,Greater MN,2022-07-14
2020-10-28,State,10182,7226,2956,6703,523,1521,1120,401,946,174,State,2022-07-14
2020-10-28,West Central,240,122,118,115,7,20,8,12,8,0,Greater MN,2022-07-14
2021-10-28,Central,778,664,114,540,124,113,101,12,65,36,Greater MN,2022-07-14
2021-10-28,Metro,4075,3915,160,3566,349,856,734,122,621,113,Metro,2022-07-14
2021-10-28,Northeast,956,577,379,521,56,110,71,39,54,17,Greater MN,2022-07-14
2021-10-28,Northwest,340,183,157,160,23,31,14,17,3,11,Greater MN,2022-07-14
2021-10-28,South Central,381,265,116,232,33,22,11,11,5,6,Greater MN,2022-07-14
2021-10-28,Southeast,1307,1144,163,1073,71,255,205,50,183,22,Greater MN,2022-07-14
2021-10-28,Southwest,365,148,217,123,25,11,5,6,3,2,Greater MN,2022-07-14
2021-10-28,State,8410,7011,1399,6309,702,1418,1151,267,939,212,State,2022-07-14
2021-10-28,West Central,208,115,93,94,21,20,10,10,5,5,Greater MN,2022-07-14
2020-10-29,Central,941,659,282,580,79,165,95,70,62,33,Greater MN,2022-07-14
2020-10-29,Metro,4888,4222,666,3888,334,868,730,138,620,110,Metro,2022-07-14
2020-10-29,Northeast,1181,606,575,576,30,143,83,60,71,12,Greater MN,2022-07-14
2020-10-29,Northwest,329,164,165,138,26,31,21,10,17,4,Greater MN,2022-07-14
2020-10-29,South Central,549,207,342,194,13,21,10,11,7,3,Greater MN,2022-07-14
2020-10-29,Southeast,1421,1035,386,995,40,251,167,84,155,12,Greater MN,2022-07-14
2020-10-29,Southwest,487,162,325,136,26,21,7,14,5,2,Greater MN,2022-07-14
2020-10-29,State,10004,7173,2831,6614,559,1520,1121,399,945,176,State,2022-07-14
2020-10-29,West Central,208,118,90,107,11,20,8,12,8,0,Greater MN,2022-07-14
2021-10-29,Central,751,634,117,514,120,112,99,13,62,37,Greater MN,2022-07-14
2021-10-29,Metro,4055,3866,189,3544,322,855,742,113,629,113,Metro,2022-07-14
2021-10-29,Northeast,943,574,369,520,54,118,72,46,53,19,Greater MN,2022-07-14
2021-10-29,Northwest,336,179,157,152,27,31,12,19,4,8,Greater MN,2022-07-14
2021-10-29,South Central,379,265,114,216,49,22,10,12,4,6,Greater MN,2022-07-14
2021-10-29,Southeast,1315,1140,175,1064,76,251,194,57,171,23,Greater MN,2022-07-14
2021-10-29,Southwest,365,141,224,110,31,10,3,7,1,2,Greater MN,2022-07-14
2021-10-29,State,8352,6903,1449,6205,698,1419,1143,276,928,215,State,2022-07-14
2021-10-29,West Central,208,104,104,85,19,20,11,9,4,7,Greater MN,2022-07-14
2020-10-30,Central,938,654,284,556,98,165,103,62,72,31,Greater MN,2022-07-14
2020-10-30,Metro,4822,4173,649,3832,341,858,744,114,635,109,Metro,2022-07-14
2020-10-30,Northeast,1189,625,564,588,37,143,78,65,65,13,Greater MN,2022-07-14
2020-10-30,Northwest,329,176,153,146,30,31,24,7,19,5,Greater MN,2022-07-14
2020-10-30,South Central,520,202,318,189,13,22,7,15,4,3,Greater MN,2022-07-14
2020-10-30,Southeast,1429,1075,354,1036,39,251,182,69,168,14,Greater MN,2022-07-14
2020-10-30,Southwest,488,151,337,126,25,21,4,17,2,2,Greater MN,2022-07-14
2020-10-30,State,9923,7150,2773,6556,594,1511,1150,361,973,177,State,2022-07-14
2020-10-30,West Central,208,94,114,83,11,20,8,12,8,0,Greater MN,2022-07-14
2021-10-30,Central,760,632,128,511,121,104,89,15,56,33,Greater MN,2022-07-14
2021-10-30,Metro,4002,3825,177,3479,346,844,736,108,625,111,Metro,2022-07-14
2021-10-30,Northeast,942,536,406,472,64,110,75,35,59,16,Greater MN,2022-07-14
2021-10-30,Northwest,335,163,172,141,22,31,20,11,9,11,Greater MN,2022-07-14
2021-10-30,South Central,373,241,132,195,46,22,11,11,5,6,Greater MN,2022-07-14
2021-10-30,Southeast,1316,1119,197,1037,82,250,193,57,168,25,Greater MN,2022-07-14
2021-10-30,Southwest,365,146,219,113,33,10,2,8,0,2,Greater MN,2022-07-14
2021-10-30,State,8301,6752,1549,6017,735,1391,1137,254,928,209,State,2022-07-14
2021-10-30,West Central,208,90,118,69,21,20,11,9,6,5,Greater MN,2022-07-14
2020-10-31,Central,932,664,268,574,90,165,99,66,69,30,Greater MN,2022-07-14
2020-10-31,Metro,4712,3959,753,3612,347,853,736,117,625,111,Metro,2022-07-14
2020-10-31,Northeast,1185,581,604,538,43,145,82,63,69,13,Greater MN,2022-07-14
2020-10-31,Northwest,329,181,148,148,33,31,20,11,14,6,Greater MN,2022-07-14
2020-10-31,South Central,521,197,324,183,14,21,7,14,4,3,Greater MN,2022-07-14
2020-10-31,Southeast,1436,1067,369,1027,40,251,163,88,148,15,Greater MN,2022-07-14
2020-10-31,Southwest,488,155,333,127,28,21,4,17,2,2,Greater MN,2022-07-14
2020-10-31,State,9811,6888,2923,6280,608,1507,1116,391,936,180,State,2022-07-14
2020-10-31,West Central,208,84,124,71,13,20,5,15,5,0,Greater MN,2022-07-14
2021-10-31,Central,733,608,125,492,116,107,92,15,54,38,Greater MN,2022-07-14
2021-10-31,Metro,3860,3635,225,3296,339,821,716,105,600,116,Metro,2022-07-14
2021-10-31,Northeast,939,533,406,478,55,116,73,43,54,19,Greater MN,2022-07-14
2021-10-31,Northwest,334,153,181,127,26,31,19,12,7,12,Greater MN,2022-07-14
2021-10-31,South Central,370,237,133,188,49,22,11,11,6,5,Greater MN,2022-07-14
2021-10-31,Southeast,1308,1054,254,971,83,248,171,77,146,25,Greater MN,2022-07-14
2021-10-31,Southwest,359,127,232,98,29,10,2,8,0,2,Greater MN,2022-07-14
2021-10-31,State,8111,6429,1682,5715,714,1375,1094,281,872,222,State,2022-07-14
2021-10-31,West Central,208,82,126,65,17,20,10,10,5,5,Greater MN,2022-07-14
2020-11-01,Central,939,637,302,543,94,165,91,74,60,31,Greater MN,2022-07-14
2020-11-01,Metro,4574,3692,882,3384,308,838,731,107,612,119,Metro,2022-07-14
2020-11-01,Northeast,1182,573,609,530,43,146,81,65,64,17,Greater MN,2022-07-14
2020-11-01,Northwest,329,172,157,136,36,31,21,10,13,8,Greater MN,2022-07-14
2020-11-01,South Central,521,189,332,171,18,21,8,13,5,3,Greater MN,2022-07-14
2020-11-01,Southeast,1424,945,479,904,41,251,140,111,123,17,Greater MN,2022-07-14
2020-11-01,Southwest,488,153,335,126,27,21,3,18,1,2,Greater MN,2022-07-14
2020-11-01,State,9665,6440,3225,5859,581,1493,1081,412,884,197,State,2022-07-14
2020-11-01,West Central,208,79,129,65,14,20,6,14,6,0,Greater MN,2022-07-14
2021-11-01,Central,751,635,116,503,132,104,90,14,51,39,Greater MN,2022-07-14
2021-11-01,Metro,3822,3602,220,3260,342,830,727,103,609,118,Metro,2022-07-14
2021-11-01,Northeast,945,525,420,463,62,119,81,38,60,21,Greater MN,2022-07-14
2021-11-01,Northwest,334,169,165,136,33,31,19,12,7,12,Greater MN,2022-07-14
2021-11-01,South Central,372,233,139,191,42,22,10,12,4,6,Greater MN,2022-07-14
2021-11-01,Southeast,1290,1029,261,935,94,250,169,81,147,22,Greater MN,2022-07-14
2021-11-01,Southwest,364,142,222,114,28,10,3,7,1,2,Greater MN,2022-07-14
2021-11-01,State,8086,6432,1654,5676,756,1386,1108,278,885,223,State,2022-07-14
2021-11-01,West Central,208,97,111,74,23,20,9,11,6,3,Greater MN,2022-07-14
2020-11-02,Central,935,621,314,516,105,165,92,73,61,31,Greater MN,2022-07-14
2020-11-02,Metro,4588,3765,823,3402,363,845,730,115,605,125,Metro,2022-07-14
2020-11-02,Northeast,1190,590,600,537,53,145,79,66,63,16,Greater MN,2022-07-14
2020-11-02,Northwest,338,166,172,126,40,31,17,14,11,6,Greater MN,2022-07-14
2020-11-02,South Central,509,185,324,167,18,21,9,12,6,3,Greater MN,2022-07-14
2020-11-02,Southeast,1411,951,460,906,45,251,141,110,126,15,Greater MN,2022-07-14
2020-11-02,Southwest,484,156,328,134,22,21,2,19,0,2,Greater MN,2022-07-14
2020-11-02,State,9663,6520,3143,5861,659,1499,1074,425,876,198,State,2022-07-14
2020-11-02,West Central,208,86,122,73,13,20,4,16,4,0,Greater MN,2022-07-14
2021-11-02,Central,784,684,100,546,138,103,89,14,52,37,Greater MN,2022-07-14
2021-11-02,Metro,4009,3860,149,3502,358,841,736,105,618,118,Metro,2022-07-14
2021-11-02,Northeast,944,564,380,502,62,110,87,23,66,21,Greater MN,2022-07-14
2021-11-02,Northwest,334,188,146,156,32,31,21,10,10,11,Greater MN,2022-07-14
2021-11-02,South Central,371,227,144,188,39,22,10,12,4,6,Greater MN,2022-07-14
2021-11-02,Southeast,1311,1078,233,990,88,251,189,62,162,27,Greater MN,2022-07-14
2021-11-02,Southwest,363,144,219,115,29,12,6,6,1,5,Greater MN,2022-07-14
2021-11-02,State,8324,6869,1455,6091,778,1390,1145,245,918,227,State,2022-07-14
2021-11-02,West Central,208,124,84,92,32,20,7,13,5,2,Greater MN,2022-07-14
2020-11-03,Central,949,647,302,546,101,166,102,64,67,35,Greater MN,2022-07-14
2020-11-03,Metro,4725,3984,741,3573,411,839,743,96,623,120,Metro,2022-07-14
2020-11-03,Northeast,1175,615,560,559,56,145,83,62,67,16,Greater MN,2022-07-14
2020-11-03,Northwest,336,177,159,136,41,33,23,10,17,6,Greater MN,2022-07-14
2020-11-03,South Central,485,197,288,182,15,21,12,9,9,3,Greater MN,2022-07-14
2020-11-03,Southeast,1417,1010,407,955,55,251,172,79,157,15,Greater MN,2022-07-14
2020-11-03,Southwest,484,170,314,146,24,21,3,18,1,2,Greater MN,2022-07-14
2020-11-03,State,9779,6896,2883,6180,716,1496,1147,349,949,198,State,2022-07-14
2020-11-03,West Central,208,96,112,83,13,20,9,11,8,1,Greater MN,2022-07-14
2021-11-03,Central,808,698,110,566,132,112,92,20,55,37,Greater MN,2022-07-14
2021-11-03,Metro,4208,4036,172,3651,385,851,736,115,616,120,Metro,2022-07-14
2021-11-03,Northeast,949,568,381,507,61,111,77,34,56,21,Greater MN,2022-07-14
2021-11-03,Northwest,351,208,143,176,32,31,21,10,8,13,Greater MN,2022-07-14
2021-11-03,South Central,373,224,149,190,34,22,10,12,3,7,Greater MN,2022-07-14
2021-11-03,Southeast,1330,1146,184,1051,95,256,200,56,173,27,Greater MN,2022-07-14
2021-11-03,Southwest,390,157,233,130,27,12,6,6,1,5,Greater MN,2022-07-14
2021-11-03,State,8649,7178,1471,6386,792,1415,1150,265,918,232,State,2022-07-14
2021-11-03,West Central,240,141,99,115,26,20,8,12,6,2,Greater MN,2022-07-14
2020-11-04,Central,994,699,295,583,116,166,99,67,65,34,Greater MN,2022-07-14
2020-11-04,Metro,4939,4246,693,3803,443,856,760,96,620,140,Metro,2022-07-14
2020-11-04,Northeast,1156,644,512,590,54,147,88,59,64,24,Greater MN,2022-07-14
2020-11-04,Northwest,373,225,148,179,46,33,22,11,16,6,Greater MN,2022-07-14
2020-11-04,South Central,519,203,316,187,16,21,11,10,7,4,Greater MN,2022-07-14
2020-11-04,Southeast,1427,1043,384,976,67,251,182,69,165,17,Greater MN,2022-07-14
2020-11-04,Southwest,484,162,322,136,26,37,4,33,2,2,Greater MN,2022-07-14
2020-11-04,State,10132,7351,2781,6572,779,1531,1177,354,948,229,State,2022-07-14
2020-11-04,West Central,240,129,111,118,11,20,11,9,9,2,Greater MN,2022-07-14
2021-11-04,Central,770,659,111,538,121,109,91,18,57,34,Greater MN,2022-07-14
2021-11-04,Metro,4075,3862,213,3490,372,859,748,111,619,129,Metro,2022-07-14
2021-11-04,Northeast,945,544,401,480,64,114,89,25,66,23,Greater MN,2022-07-14
2021-11-04,Northwest,334,193,141,161,32,31,21,10,9,12,Greater MN,2022-07-14
2021-11-04,South Central,373,239,134,207,32,22,11,11,4,7,Greater MN,2022-07-14
2021-11-04,Southeast,1311,1125,186,1045,80,253,202,51,177,25,Greater MN,2022-07-14
2021-11-04,Southwest,366,134,232,107,27,12,6,6,2,4,Greater MN,2022-07-14
2021-11-04,State,8382,6872,1510,6120,752,1420,1176,244,941,235,State,2022-07-14
2021-11-04,West Central,208,116,92,92,24,20,8,12,7,1,Greater MN,2022-07-14
2020-11-05,Central,959,654,305,533,121,166,93,73,58,35,Greater MN,2022-07-14
2020-11-05,Metro,4786,4190,596,3716,474,833,734,99,599,135,Metro,2022-07-14
2020-11-05,Northeast,1164,582,582,522,60,147,88,59,63,25,Greater MN,2022-07-14
2020-11-05,Northwest,357,192,165,153,39,33,20,13,14,6,Greater MN,2022-07-14
2020-11-05,South Central,519,215,304,190,25,21,11,10,9,2,Greater MN,2022-07-14
2020-11-05,Southeast,1414,1056,358,987,69,251,180,71,161,19,Greater MN,2022-07-14
2020-11-05,Southwest,484,143,341,120,23,21,4,17,2,2,Greater MN,2022-07-14
2020-11-05,State,9891,7127,2764,6302,825,1492,1141,351,915,226,State,2022-07-14
2020-11-05,West Central,208,95,113,81,14,20,11,9,9,2,Greater MN,2022-07-14
2021-11-05,Central,753,637,116,522,115,111,96,15,57,39,Greater MN,2022-07-14
2021-11-05,Metro,4023,3826,197,3447,379,863,758,105,634,124,Metro,2022-07-14
2021-11-05,Northeast,946,550,396,480,70,110,76,34,56,20,Greater MN,2022-07-14
2021-11-05,Northwest,334,184,150,154,30,31,23,8,12,11,Greater MN,2022-07-14
2021-11-05,South Central,365,251,114,220,31,22,10,12,5,5,Greater MN,2022-07-14
2021-11-05,Southeast,1314,1115,199,1027,88,252,195,57,170,25,Greater MN,2022-07-14
2021-11-05,Southwest,380,148,232,120,28,11,5,6,2,3,Greater MN,2022-07-14
2021-11-05,State,8323,6829,1494,6069,760,1420,1171,249,944,227,State,2022-07-14
2021-11-05,West Central,208,118,90,99,19,20,8,12,8,0,Greater MN,2022-07-14
2020-11-06,Central,960,636,324,513,123,167,102,65,63,39,Greater MN,2022-07-14
2020-11-06,Metro,4798,4240,558,3753,487,824,720,104,587,133,Metro,2022-07-14
2020-11-06,Northeast,1152,602,550,540,62,118,82,36,59,23,Greater MN,2022-07-14
2020-11-06,Northwest,356,193,163,153,40,34,18,16,11,7,Greater MN,2022-07-14
2020-11-06,South Central,519,215,304,186,29,21,10,11,7,3,Greater MN,2022-07-14
2020-11-06,Southeast,1403,1034,369,958,76,284,170,114,151,19,Greater MN,2022-07-14
2020-11-06,Southwest,483,154,329,124,30,21,5,16,3,2,Greater MN,2022-07-14
2020-11-06,State,9879,7163,2716,6306,857,1489,1115,374,886,229,State,2022-07-14
2020-11-06,West Central,208,89,119,79,10,20,8,12,5,3,Greater MN,2022-07-14
2021-11-06,Central,737,620,117,495,125,107,97,10,57,40,Greater MN,2022-07-14
2021-11-06,Metro,4034,3807,227,3422,385,849,763,86,637,126,Metro,2022-07-14
2021-11-06,Northeast,939,515,424,450,65,118,85,33,63,22,Greater MN,2022-07-14
2021-11-06,Northwest,334,172,162,145,27,31,19,12,5,14,Greater MN,2022-07-14
2021-11-06,South Central,364,244,120,218,26,22,9,13,4,5,Greater MN,2022-07-14
2021-11-06,Southeast,1305,1078,227,997,81,252,196,56,172,24,Greater MN,2022-07-14
2021-11-06,Southwest,378,158,220,132,26,11,5,6,1,4,Greater MN,2022-07-14
2021-11-06,State,8299,6692,1607,5936,756,1410,1183,227,948,235,State,2022-07-14
2021-11-06,West Central,208,98,110,77,21,20,9,11,9,0,Greater MN,2022-07-14
2020-11-07,Central,959,640,319,511,129,165,101,64,64,37,Greater MN,2022-07-14
2020-11-07,Metro,4634,4007,627,3502,505,840,714,126,575,139,Metro,2022-07-14
2020-11-07,Northeast,1144,568,576,505,63,115,73,42,48,25,Greater MN,2022-07-14
2020-11-07,Northwest,358,189,169,141,48,32,23,9,15,8,Greater MN,2022-07-14
2020-11-07,South Central,479,201,278,170,31,27,9,18,4,5,Greater MN,2022-07-14
2020-11-07,Southeast,1386,979,407,902,77,250,168,82,149,19,Greater MN,2022-07-14
2020-11-07,Southwest,483,155,328,125,30,21,3,18,1,2,Greater MN,2022-07-14
2020-11-07,State,9651,6827,2824,5931,896,1470,1099,371,863,236,State,2022-07-14
2020-11-07,West Central,208,88,120,75,13,20,8,12,7,1,Greater MN,2022-07-14
2021-11-07,Central,747,632,115,492,140,112,102,10,59,43,Greater MN,2022-07-14
2021-11-07,Metro,3978,3713,265,3303,410,851,761,90,624,137,Metro,2022-07-14
2021-11-07,Northeast,938,514,424,441,73,118,88,30,66,22,Greater MN,2022-07-14
2021-11-07,Northwest,334,175,159,150,25,31,16,15,3,13,Greater MN,2022-07-14
2021-11-07,South Central,363,232,131,205,27,22,11,11,6,5,Greater MN,2022-07-14
2021-11-07,Southeast,1301,1058,243,965,93,253,185,68,160,25,Greater MN,2022-07-14
2021-11-07,Southwest,378,158,220,132,26,11,7,4,2,5,Greater MN,2022-07-14
2021-11-07,State,8247,6578,1669,5759,819,1418,1179,239,929,250,State,2022-07-14
2021-11-07,West Central,208,96,112,71,25,20,9,11,9,0,Greater MN,2022-07-14
2020-11-08,Central,953,606,347,475,131,166,101,65,61,40,Greater MN,2022-07-14
2020-11-08,Metro,4491,3926,565,3414,512,836,699,137,555,144,Metro,2022-07-14
2020-11-08,Northeast,1142,564,578,489,75,116,78,38,54,24,Greater MN,2022-07-14
2020-11-08,Northwest,359,192,167,142,50,31,15,16,10,5,Greater MN,2022-07-14
2020-11-08,South Central,479,203,276,165,38,27,8,19,4,4,Greater MN,2022-07-14
2020-11-08,Southeast,1385,913,472,836,77,250,148,102,128,20,Greater MN,2022-07-14
2020-11-08,Southwest,484,148,336,113,35,21,6,15,4,2,Greater MN,2022-07-14
2020-11-08,State,9501,6632,2869,5702,930,1467,1064,403,824,240,State,2022-07-14
2020-11-08,West Central,208,80,128,68,12,20,9,11,8,1,Greater MN,2022-07-14
2021-11-08,Central,742,626,116,487,139,111,100,11,52,48,Greater MN,2022-07-14
2021-11-08,Metro,3997,3775,222,3330,445,830,740,90,610,130,Metro,2022-07-14
2021-11-08,Northeast,931,514,417,433,81,118,80,38,58,22,Greater MN,2022-07-14
2021-11-08,Northwest,334,189,145,160,29,31,19,12,7,12,Greater MN,2022-07-14
2021-11-08,South Central,363,237,126,201,36,23,12,11,7,5,Greater MN,2022-07-14
2021-11-08,Southeast,1299,1073,226,974,99,252,185,67,159,26,Greater MN,2022-07-14
2021-11-08,Southwest,376,145,231,120,25,11,5,6,1,4,Greater MN,2022-07-14
2021-11-08,State,8250,6659,1591,5783,876,1396,1151,245,902,249,State,2022-07-14
2021-11-08,West Central,208,100,108,78,22,20,10,10,8,2,Greater MN,2022-07-14
2020-11-09,Central,805,624,181,476,148,139,91,48,53,38,Greater MN,2022-07-14
2020-11-09,Metro,4450,3870,580,3343,527,853,732,121,583,149,Metro,2022-07-14
2020-11-09,Northeast,1164,587,577,510,77,116,81,35,57,24,Greater MN,2022-07-14
2020-11-09,Northwest,365,207,158,157,50,31,14,17,8,6,Greater MN,2022-07-14
2020-11-09,South Central,479,204,275,168,36,27,9,18,3,6,Greater MN,2022-07-14
2020-11-09,Southeast,1379,890,489,810,80,250,139,111,115,24,Greater MN,2022-07-14
2020-11-09,Southwest,418,144,274,102,42,17,5,12,3,2,Greater MN,2022-07-14
2020-11-09,State,9265,6605,2660,5631,974,1453,1078,375,829,249,State,2022-07-14
2020-11-09,West Central,205,79,126,65,14,20,7,13,7,0,Greater MN,2022-07-14
2021-11-09,Central,764,666,98,513,153,118,111,7,63,48,Greater MN,2022-07-14
2021-11-09,Metro,4079,3900,179,3417,483,847,745,102,614,131,Metro,2022-07-14
2021-11-09,Northeast,950,552,398,472,80,118,81,37,56,25,Greater MN,2022-07-14
2021-11-09,Northwest,334,189,145,161,28,31,21,10,8,13,Greater MN,2022-07-14
2021-11-09,South Central,362,245,117,217,28,23,11,12,5,6,Greater MN,2022-07-14
2021-11-09,Southeast,1308,1116,192,1028,88,254,203,51,174,29,Greater MN,2022-07-14
2021-11-09,Southwest,375,145,230,124,21,11,5,6,1,4,Greater MN,2022-07-14
2021-11-09,State,8380,6938,1442,6033,905,1422,1186,236,929,257,State,2022-07-14
2021-11-09,West Central,208,125,83,101,24,20,9,11,8,1,Greater MN,2022-07-14
2020-11-10,Central,825,673,152,526,147,143,104,39,62,42,Greater MN,2022-07-14
2020-11-10,Metro,4646,4059,587,3510,549,851,732,119,568,164,Metro,2022-07-14
2020-11-10,Northeast,1144,600,544,520,80,115,85,30,58,27,Greater MN,2022-07-14
2020-11-10,Northwest,355,218,137,171,47,35,20,15,3,17,Greater MN,2022-07-14
2020-11-10,South Central,477,216,261,182,34,29,13,16,8,5,Greater MN,2022-07-14
2020-11-10,Southeast,1396,953,443,863,90,250,155,95,132,23,Greater MN,2022-07-14
2020-11-10,Southwest,424,164,260,111,53,18,6,12,2,4,Greater MN,2022-07-14
2020-11-10,State,9472,6976,2496,5960,1016,1461,1121,340,838,283,State,2022-07-14
2020-11-10,West Central,205,93,112,77,16,20,6,14,5,1,Greater MN,2022-07-14
2021-11-10,Central,808,705,103,555,150,121,110,11,59,51,Greater MN,2022-07-14
2021-11-10,Metro,4293,4133,160,3654,479,858,745,113,602,143,Metro,2022-07-14
2021-11-10,Northeast,950,559,391,480,79,114,88,26,57,31,Greater MN,2022-07-14
2021-11-10,Northwest,350,194,156,160,34,31,18,13,5,13,Greater MN,2022-07-14
2021-11-10,South Central,361,258,103,233,25,23,12,11,7,5,Greater MN,2022-07-14
2021-11-10,Southeast,1324,1156,168,1067,89,254,206,48,177,29,Greater MN,2022-07-14
2021-11-10,Southwest,395,165,230,145,20,13,7,6,3,4,Greater MN,2022-07-14
2021-11-10,State,8720,7316,1404,6414,902,1435,1197,238,916,281,State,2022-07-14
2021-11-10,West Central,239,146,93,120,26,21,11,10,6,5,Greater MN,2022-07-14
2020-11-11,Central,849,700,149,538,162,143,104,39,57,47,Greater MN,2022-07-14
2020-11-11,Metro,4853,4214,639,3619,595,869,739,130,568,171,Metro,2022-07-14
2020-11-11,Northeast,1099,580,519,491,89,109,86,23,59,27,Greater MN,2022-07-14
2020-11-11,Northwest,367,219,148,173,46,35,23,12,6,17,Greater MN,2022-07-14
2020-11-11,South Central,476,223,253,184,39,30,15,15,8,7,Greater MN,2022-07-14
2020-11-11,Southeast,1388,1001,387,901,100,241,173,68,148,25,Greater MN,2022-07-14
2020-11-11,Southwest,437,171,266,118,53,17,8,9,5,3,Greater MN,2022-07-14
2020-11-11,State,9706,7230,2476,6131,1099,1464,1157,307,859,298,State,2022-07-14
2020-11-11,West Central,237,122,115,107,15,20,9,11,8,1,Greater MN,2022-07-14
2021-11-11,Central,755,651,104,507,144,120,109,11,59,50,Greater MN,2022-07-14
2021-11-11,Metro,4105,3942,163,3422,520,860,758,102,610,148,Metro,2022-07-14
2021-11-11,Northeast,949,546,403,465,81,122,100,22,61,39,Greater MN,2022-07-14
2021-11-11,Northwest,334,190,144,159,31,31,18,13,6,12,Greater MN,2022-07-14
2021-11-11,South Central,363,265,98,234,31,22,11,11,6,5,Greater MN,2022-07-14
2021-11-11,Southeast,1319,1140,179,1047,93,254,211,43,179,32,Greater MN,2022-07-14
2021-11-11,Southwest,380,167,213,149,18,13,7,6,3,4,Greater MN,2022-07-14
2021-11-11,State,8413,7011,1402,6055,956,1442,1224,218,931,293,State,2022-07-14
2021-11-11,West Central,208,110,98,72,38,20,10,10,7,3,Greater MN,2022-07-14
2020-11-12,Central,830,683,147,525,158,149,104,45,54,50,Greater MN,2022-07-14
2020-11-12,Metro,4812,4198,614,3581,617,860,739,121,566,173,Metro,2022-07-14
2020-11-12,Northeast,1101,586,515,502,84,108,80,28,55,25,Greater MN,2022-07-14
2020-11-12,Northwest,355,204,151,156,48,35,23,12,7,16,Greater MN,2022-07-14
2020-11-12,South Central,484,234,250,196,38,28,11,17,7,4,Greater MN,2022-07-14
2020-11-12,Southeast,1379,972,407,864,108,241,176,65,154,22,Greater MN,2022-07-14
2020-11-12,Southwest,426,168,258,118,50,15,6,9,4,2,Greater MN,2022-07-14
2020-11-12,State,9592,7130,2462,5999,1131,1456,1145,311,853,292,State,2022-07-14
2020-11-12,West Central,205,85,120,57,28,20,6,14,6,0,Greater MN,2022-07-14
2021-11-12,Central,766,665,101,519,146,112,102,10,51,51,Greater MN,2022-07-14
2021-11-12,Metro,4081,3958,123,3416,542,858,758,100,604,154,Metro,2022-07-14
2021-11-12,Northeast,949,548,401,462,86,121,98,23,58,40,Greater MN,2022-07-14
2021-11-12,Northwest,334,193,141,166,27,31,21,10,5,16,Greater MN,2022-07-14
2021-11-12,South Central,363,238,125,209,29,22,8,14,4,4,Greater MN,2022-07-14
2021-11-12,Southeast,1326,1141,185,1051,90,256,198,58,159,39,Greater MN,2022-07-14
2021-11-12,Southwest,374,157,217,139,18,12,6,6,2,4,Greater MN,2022-07-14
2021-11-12,State,8401,7006,1395,6031,975,1432,1202,230,892,310,State,2022-07-14
2021-11-12,West Central,208,106,102,69,37,20,11,9,9,2,Greater MN,2022-07-14
2020-11-13,Central,802,645,157,483,162,147,99,48,52,47,Greater MN,2022-07-14
2020-11-13,Metro,4560,4115,445,3466,649,845,728,117,561,167,Metro,2022-07-14
2020-11-13,Northeast,1088,580,508,492,88,114,82,32,56,26,Greater MN,2022-07-14
2020-11-13,Northwest,355,202,153,153,49,35,22,13,6,16,Greater MN,2022-07-14
2020-11-13,South Central,471,225,246,183,42,27,9,18,5,4,Greater MN,2022-07-14
2020-11-13,Southeast,1342,981,361,883,98,237,177,60,149,28,Greater MN,2022-07-14
2020-11-13,Southwest,422,158,264,108,50,16,6,10,3,3,Greater MN,2022-07-14
2020-11-13,State,9245,6988,2257,5823,1165,1441,1131,310,839,292,State,2022-07-14
2020-11-13,West Central,205,82,123,55,27,20,8,12,7,1,Greater MN,2022-07-14
2021-11-13,Central,765,655,110,492,163,111,97,14,50,47,Greater MN,2022-07-14
2021-11-13,Metro,4003,3850,153,3339,511,862,759,103,599,160,Metro,2022-07-14
2021-11-13,Northeast,948,521,427,434,87,121,97,24,61,36,Greater MN,2022-07-14
2021-11-13,Northwest,334,186,148,162,24,31,21,10,5,16,Greater MN,2022-07-14
2021-11-13,South Central,359,241,118,206,35,22,8,14,4,4,Greater MN,2022-07-14
2021-11-13,Southeast,1318,1084,234,1000,84,256,196,60,156,40,Greater MN,2022-07-14
2021-11-13,Southwest,366,134,232,112,22,13,7,6,3,4,Greater MN,2022-07-14
2021-11-13,State,8301,6772,1529,5816,956,1436,1196,240,885,311,State,2022-07-14
2021-11-13,West Central,208,101,107,71,30,20,11,9,7,4,Greater MN,2022-07-14
2020-11-14,Central,798,658,140,493,165,148,103,45,56,47,Greater MN,2022-07-14
2020-11-14,Metro,4463,3882,581,3236,646,845,699,146,516,183,Metro,2022-07-14
2020-11-14,Northeast,1088,528,560,447,81,114,84,30,57,27,Greater MN,2022-07-14
2020-11-14,Northwest,350,185,165,140,45,36,29,7,11,18,Greater MN,2022-07-14
2020-11-14,South Central,464,239,225,182,57,27,14,13,8,6,Greater MN,2022-07-14
2020-11-14,Southeast,1349,909,440,813,96,240,177,63,150,27,Greater MN,2022-07-14
2020-11-14,Southwest,418,161,257,106,55,15,8,7,5,3,Greater MN,2022-07-14
2020-11-14,State,9135,6643,2492,5471,1172,1445,1123,322,811,312,State,2022-07-14
2020-11-14,West Central,205,81,124,54,27,20,9,11,8,1,Greater MN,2022-07-14
2021-11-14,Central,717,598,119,433,165,113,97,16,51,46,Greater MN,2022-07-14
2021-11-14,Metro,3930,3719,211,3180,539,857,746,111,593,153,Metro,2022-07-14
2021-11-14,Northeast,939,533,406,450,83,118,96,22,62,34,Greater MN,2022-07-14
2021-11-14,Northwest,334,185,149,149,36,31,20,11,4,16,Greater MN,2022-07-14
2021-11-14,South Central,361,242,119,210,32,22,9,13,4,5,Greater MN,2022-07-14
2021-11-14,Southeast,1334,1046,288,953,93,254,184,70,141,43,Greater MN,2022-07-14
2021-11-14,Southwest,363,132,231,109,23,14,7,7,3,4,Greater MN,2022-07-14
2021-11-14,State,8187,6562,1625,5562,1000,1429,1170,259,867,303,State,2022-07-14
2021-11-14,West Central,209,107,102,78,29,20,11,9,9,2,Greater MN,2022-07-14
2020-11-15,Central,794,627,167,452,175,151,105,46,55,50,Greater MN,2022-07-14
2020-11-15,Metro,4384,3838,546,3158,680,832,706,126,519,187,Metro,2022-07-14
2020-11-15,Northeast,1092,550,542,456,94,116,88,28,53,35,Greater MN,2022-07-14
2020-11-15,Northwest,352,191,161,140,51,34,25,9,7,18,Greater MN,2022-07-14
2020-11-15,South Central,460,228,232,174,54,27,14,13,8,6,Greater MN,2022-07-14
2020-11-15,Southeast,1338,849,489,743,106,241,170,71,146,24,Greater MN,2022-07-14
2020-11-15,Southwest,415,160,255,105,55,15,6,9,4,2,Greater MN,2022-07-14
2020-11-15,State,9041,6533,2508,5288,1245,1436,1121,315,797,324,State,2022-07-14
2020-11-15,West Central,206,90,116,60,30,20,7,13,5,2,Greater MN,2022-07-14
2021-11-15,Central,723,614,109,447,167,117,107,10,61,46,Greater MN,2022-07-14
2021-11-15,Metro,3935,3735,200,3166,569,851,740,111,582,158,Metro,2022-07-14
2021-11-15,Northeast,943,524,419,439,85,128,101,27,70,31,Greater MN,2022-07-14
2021-11-15,Northwest,334,176,158,141,35,31,23,8,5,18,Greater MN,2022-07-14
2021-11-15,South Central,365,254,111,218,36,23,9,14,2,7,Greater MN,2022-07-14
2021-11-15,Southeast,1316,1032,284,938,94,253,185,68,143,42,Greater MN,2022-07-14
2021-11-15,Southwest,365,140,225,109,31,13,6,7,3,3,Greater MN,2022-07-14
2021-11-15,State,8189,6576,1613,5531,1045,1436,1180,256,873,307,State,2022-07-14
2021-11-15,West Central,208,101,107,73,28,20,9,11,7,2,Greater MN,2022-07-14
2020-11-16,Central,791,624,167,442,182,148,106,42,49,57,Greater MN,2022-07-14
2020-11-16,Metro,4388,3843,545,3122,721,842,705,137,517,188,Metro,2022-07-14
2020-11-16,Northeast,1086,574,512,462,112,118,91,27,49,42,Greater MN,2022-07-14
2020-11-16,Northwest,355,201,154,145,56,34,23,11,4,19,Greater MN,2022-07-14
2020-11-16,South Central,463,224,239,164,60,28,16,12,9,7,Greater MN,2022-07-14
2020-11-16,Southeast,1334,828,506,732,96,241,155,86,127,28,Greater MN,2022-07-14
2020-11-16,Southwest,415,163,252,103,60,15,8,7,5,3,Greater MN,2022-07-14
2020-11-16,State,9037,6540,2497,5222,1318,1446,1111,335,766,345,State,2022-07-14
2020-11-16,West Central,205,83,122,52,31,20,7,13,6,1,Greater MN,2022-07-14
2021-11-16,Central,754,658,96,489,169,120,108,12,62,46,Greater MN,2022-07-14
2021-11-16,Metro,4091,3934,157,3346,588,865,765,100,594,171,Metro,2022-07-14
2021-11-16,Northeast,962,542,420,453,89,126,102,24,71,31,Greater MN,2022-07-14
2021-11-16,Northwest,334,172,162,137,35,32,24,8,5,19,Greater MN,2022-07-14
2021-11-16,South Central,363,253,110,218,35,22,11,11,4,7,Greater MN,2022-07-14
2021-11-16,Southeast,1313,1085,228,1001,84,253,194,59,154,40,Greater MN,2022-07-14
2021-11-16,Southwest,371,157,214,126,31,12,5,7,2,3,Greater MN,2022-07-14
2021-11-16,State,8397,6919,1478,5854,1065,1449,1214,235,894,320,State,2022-07-14
2021-11-16,West Central,209,118,91,84,34,19,5,14,2,3,Greater MN,2022-07-14
2020-11-17,Central,796,638,158,449,189,145,102,43,52,50,Greater MN,2022-07-14
2020-11-17,Metro,4417,3923,494,3180,743,845,722,123,531,191,Metro,2022-07-14
2020-11-17,Northeast,1082,577,505,468,109,122,97,25,50,47,Greater MN,2022-07-14
2020-11-17,Northwest,355,201,154,146,55,32,22,10,4,18,Greater MN,2022-07-14
2020-11-17,South Central,459,226,233,162,64,27,16,11,9,7,Greater MN,2022-07-14
2020-11-17,Southeast,1329,843,486,745,98,239,187,52,151,36,Greater MN,2022-07-14
2020-11-17,Southwest,390,176,214,103,73,15,6,9,2,4,Greater MN,2022-07-14
2020-11-17,State,9033,6683,2350,5321,1362,1445,1156,289,801,355,State,2022-07-14
2020-11-17,West Central,205,99,106,68,31,20,4,16,2,2,Greater MN,2022-07-14
2021-11-17,Central,783,688,95,523,165,119,113,6,63,50,Greater MN,2022-07-14
2021-11-17,Metro,4295,4091,204,3497,594,874,769,105,596,173,Metro,2022-07-14
2021-11-17,Northeast,969,569,400,476,93,127,99,28,68,31,Greater MN,2022-07-14
2021-11-17,Northwest,349,193,156,161,32,33,23,10,6,17,Greater MN,2022-07-14
2021-11-17,South Central,347,245,102,213,32,22,12,10,3,9,Greater MN,2022-07-14
2021-11-17,Southeast,1336,1135,201,1055,80,254,203,51,158,45,Greater MN,2022-07-14
2021-11-17,Southwest,391,156,235,127,29,11,4,7,0,4,Greater MN,2022-07-14
2021-11-17,State,8711,7243,1468,6186,1057,1459,1232,227,899,333,State,2022-07-14
2021-11-17,West Central,241,166,75,134,32,19,9,10,5,4,Greater MN,2022-07-14
2020-11-18,Central,811,666,145,478,188,149,112,37,54,58,Greater MN,2022-07-14
2020-11-18,Metro,4713,4257,456,3501,756,860,719,141,519,200,Metro,2022-07-14
2020-11-18,Northeast,1076,587,489,468,119,120,99,21,58,41,Greater MN,2022-07-14
2020-11-18,Northwest,371,209,162,160,49,31,18,13,5,13,Greater MN,2022-07-14
2020-11-18,South Central,454,230,224,169,61,29,18,11,7,11,Greater MN,2022-07-14
2020-11-18,Southeast,1351,897,454,794,103,239,184,55,146,38,Greater MN,2022-07-14
2020-11-18,Southwest,415,199,216,132,67,14,5,9,2,3,Greater MN,2022-07-14
2020-11-18,State,9428,7189,2239,5809,1380,1462,1163,299,797,366,State,2022-07-14
2020-11-18,West Central,237,144,93,107,37,20,8,12,6,2,Greater MN,2022-07-14
2021-11-18,Central,785,685,100,513,172,117,106,11,57,49,Greater MN,2022-07-14
2021-11-18,Metro,4058,3879,179,3271,608,880,774,106,596,178,Metro,2022-07-14
2021-11-18,Northeast,966,550,416,459,91,129,99,30,69,30,Greater MN,2022-07-14
2021-11-18,Northwest,334,178,156,141,37,31,22,9,4,18,Greater MN,2022-07-14
2021-11-18,South Central,367,247,120,207,40,22,11,11,3,8,Greater MN,2022-07-14
2021-11-18,Southeast,1328,1157,171,1080,77,252,199,53,152,47,Greater MN,2022-07-14
2021-11-18,Southwest,368,141,227,116,25,13,7,6,1,6,Greater MN,2022-07-14
2021-11-18,State,8415,6973,1442,5892,1081,1463,1227,236,887,340,State,2022-07-14
2021-11-18,West Central,209,136,73,105,31,19,9,10,5,4,Greater MN,2022-07-14
2020-11-19,Central,799,663,136,458,205,147,103,44,43,60,Greater MN,2022-07-14
2020-11-19,Metro,4554,4095,459,3320,775,852,721,131,523,198,Metro,2022-07-14
2020-11-19,Northeast,1081,573,508,457,116,122,94,28,48,46,Greater MN,2022-07-14
2020-11-19,Northwest,347,215,132,165,50,31,17,14,7,10,Greater MN,2022-07-14
2020-11-19,South Central,455,221,234,154,67,29,17,12,5,12,Greater MN,2022-07-14
2020-11-19,Southeast,1324,878,446,775,103,252,168,84,134,34,Greater MN,2022-07-14
2020-11-19,Southwest,386,184,202,119,65,16,8,8,3,5,Greater MN,2022-07-14
2020-11-19,State,9151,6952,2199,5538,1414,1469,1137,332,770,367,State,2022-07-14
2020-11-19,West Central,205,123,82,90,33,20,9,11,7,2,Greater MN,2022-07-14
2021-11-19,Central,789,670,119,508,162,115,106,9,58,48,Greater MN,2022-07-14
2021-11-19,Metro,4030,3851,179,3261,590,883,774,109,595,179,Metro,2022-07-14
2021-11-19,Northeast,973,563,410,470,93,130,99,31,73,26,Greater MN,2022-07-14
2021-11-19,Northwest,335,175,160,138,37,31,23,8,4,19,Greater MN,2022-07-14
2021-11-19,South Central,367,246,121,208,38,22,10,12,3,7,Greater MN,2022-07-14
2021-11-19,Southeast,1320,1170,150,1093,77,259,201,58,160,41,Greater MN,2022-07-14
2021-11-19,Southwest,361,141,220,122,19,12,8,4,2,6,Greater MN,2022-07-14
2021-11-19,State,8384,6935,1449,5891,1044,1471,1230,241,900,330,State,2022-07-14
2021-11-19,West Central,209,119,90,91,28,19,9,10,5,4,Greater MN,2022-07-14
2020-11-20,Central,763,632,131,426,206,149,105,44,48,57,Greater MN,2022-07-14
2020-11-20,Metro,4315,3909,406,3106,803,844,729,115,531,198,Metro,2022-07-14
2020-11-20,Northeast,1077,560,517,451,109,123,96,27,57,39,Greater MN,2022-07-14
2020-11-20,Northwest,347,210,137,159,51,31,20,11,7,13,Greater MN,2022-07-14
2020-11-20,South Central,454,228,226,149,79,26,15,11,5,10,Greater MN,2022-07-14
2020-11-20,Southeast,1336,899,437,807,92,253,184,69,148,36,Greater MN,2022-07-14
2020-11-20,Southwest,388,175,213,105,70,16,7,9,3,4,Greater MN,2022-07-14
2020-11-20,State,8886,6720,2166,5279,1441,1461,1166,295,805,361,State,2022-07-14
2020-11-20,West Central,206,107,99,76,31,19,10,9,6,4,Greater MN,2022-07-14
2021-11-20,Central,775,647,128,488,159,108,103,5,50,53,Greater MN,2022-07-14
2021-11-20,Metro,4015,3830,185,3246,584,870,768,102,591,177,Metro,2022-07-14
2021-11-20,Northeast,962,539,423,444,95,130,101,29,77,24,Greater MN,2022-07-14
2021-11-20,Northwest,334,159,175,117,42,31,22,9,4,18,Greater MN,2022-07-14
2021-11-20,South Central,367,235,132,193,42,22,10,12,3,7,Greater MN,2022-07-14
2021-11-20,Southeast,1313,1120,193,1045,75,256,205,51,158,47,Greater MN,2022-07-14
2021-11-20,Southwest,358,126,232,108,18,11,5,6,0,5,Greater MN,2022-07-14
2021-11-20,State,8334,6758,1576,5719,1039,1446,1223,223,887,336,State,2022-07-14
2021-11-20,West Central,210,102,108,78,24,18,9,9,4,5,Greater MN,2022-07-14
2020-11-21,Central,753,604,149,400,204,145,98,47,36,62,Greater MN,2022-07-14
2020-11-21,Metro,4306,3845,461,3059,786,859,730,129,530,200,Metro,2022-07-14
2020-11-21,Northeast,1087,532,555,422,110,123,94,29,55,39,Greater MN,2022-07-14
2020-11-21,Northwest,345,186,159,136,50,33,26,7,12,14,Greater MN,2022-07-14
2020-11-21,South Central,453,224,229,151,73,26,14,12,7,7,Greater MN,2022-07-14
2020-11-21,Southeast,1325,858,467,761,97,251,174,77,137,37,Greater MN,2022-07-14
2020-11-21,Southwest,381,167,214,109,58,14,5,9,3,2,Greater MN,2022-07-14
2020-11-21,State,8856,6522,2334,5114,1408,1470,1147,323,783,364,State,2022-07-14
2020-11-21,West Central,206,106,100,76,30,19,6,13,3,3,Greater MN,2022-07-14
2021-11-21,Central,778,639,139,481,158,104,98,6,47,51,Greater MN,2022-07-14
2021-11-21,Metro,3972,3842,130,3254,588,852,742,110,564,178,Metro,2022-07-14
2021-11-21,Northeast,946,546,400,446,100,115,93,22,70,23,Greater MN,2022-07-14
2021-11-21,Northwest,334,151,183,108,43,31,20,11,5,15,Greater MN,2022-07-14
2021-11-21,South Central,368,227,141,179,48,22,10,12,4,6,Greater MN,2022-07-14
2021-11-21,Southeast,1310,1016,294,937,79,255,190,65,143,47,Greater MN,2022-07-14
2021-11-21,Southwest,367,138,229,107,31,11,4,7,0,4,Greater MN,2022-07-14
2021-11-21,State,8285,6664,1621,5594,1070,1408,1163,245,835,328,State,2022-07-14
2021-11-21,West Central,210,105,105,82,23,18,6,12,2,4,Greater MN,2022-07-14
2020-11-22,Central,759,606,153,397,209,146,99,47,39,60,Greater MN,2022-07-14
2020-11-22,Metro,4193,3710,483,2931,779,850,711,139,501,210,Metro,2022-07-14
2020-11-22,Northeast,1081,531,550,408,123,125,95,30,58,37,Greater MN,2022-07-14
2020-11-22,Northwest,346,188,158,136,52,32,23,9,10,13,Greater MN,2022-07-14
2020-11-22,South Central,452,216,236,146,70,26,13,13,4,9,Greater MN,2022-07-14
2020-11-22,Southeast,1325,808,517,713,95,251,149,102,117,32,Greater MN,2022-07-14
2020-11-22,Southwest,371,167,204,97,70,13,4,9,3,1,Greater MN,2022-07-14
2020-11-22,State,8732,6327,2405,4899,1428,1463,1101,362,737,364,State,2022-07-14
2020-11-22,West Central,205,101,104,71,30,20,7,13,5,2,Greater MN,2022-07-14
2021-11-22,Central,766,641,125,468,173,103,93,10,48,45,Greater MN,2022-07-14
2021-11-22,Metro,3986,3799,187,3192,607,849,753,96,572,181,Metro,2022-07-14
2021-11-22,Northeast,954,537,417,437,100,114,95,19,70,25,Greater MN,2022-07-14
2021-11-22,Northwest,334,150,184,105,45,31,19,12,5,14,Greater MN,2022-07-14
2021-11-22,South Central,362,240,122,190,50,22,11,11,5,6,Greater MN,2022-07-14
2021-11-22,Southeast,1316,1020,296,935,85,255,176,79,135,41,Greater MN,2022-07-14
2021-11-22,Southwest,373,133,240,103,30,11,3,8,0,3,Greater MN,2022-07-14
2021-11-22,State,8301,6619,1682,5509,1110,1403,1157,246,837,320,State,2022-07-14
2021-11-22,West Central,210,99,111,79,20,18,7,11,2,5,Greater MN,2022-07-14
2020-11-23,Central,746,587,159,371,216,150,105,45,42,63,Greater MN,2022-07-14
2020-11-23,Metro,4140,3667,473,2871,796,844,716,128,502,214,Metro,2022-07-14
2020-11-23,Northeast,1084,548,536,432,116,124,97,27,55,42,Greater MN,2022-07-14
2020-11-23,Northwest,344,189,155,141,48,37,28,9,12,16,Greater MN,2022-07-14
2020-11-23,South Central,450,234,216,169,65,26,14,12,4,10,Greater MN,2022-07-14
2020-11-23,Southeast,1340,819,521,716,103,251,138,113,109,29,Greater MN,2022-07-14
2020-11-23,Southwest,374,169,205,100,69,14,4,10,2,2,Greater MN,2022-07-14
2020-11-23,State,8683,6312,2371,4867,1445,1466,1110,356,733,377,State,2022-07-14
2020-11-23,West Central,205,99,106,67,32,20,8,12,7,1,Greater MN,2022-07-14
2021-11-23,Central,793,683,110,514,169,118,109,9,60,49,Greater MN,2022-07-14
2021-11-23,Metro,4045,3862,183,3261,601,859,768,91,580,188,Metro,2022-07-14
2021-11-23,Northeast,940,531,409,443,88,124,97,27,69,28,Greater MN,2022-07-14
2021-11-23,Northwest,334,167,167,123,44,31,17,14,4,13,Greater MN,2022-07-14
2021-11-23,South Central,366,257,109,205,52,22,10,12,7,3,Greater MN,2022-07-14
2021-11-23,Southeast,1308,1073,235,985,88,257,193,64,156,37,Greater MN,2022-07-14
2021-11-23,Southwest,375,145,230,116,29,11,4,7,1,3,Greater MN,2022-07-14
2021-11-23,State,8371,6826,1545,5730,1096,1440,1205,235,879,326,State,2022-07-14
2021-11-23,West Central,210,108,102,83,25,18,7,11,2,5,Greater MN,2022-07-14
2020-11-24,Central,761,608,153,410,198,148,110,38,43,67,Greater MN,2022-07-14
2020-11-24,Metro,4258,3779,479,2973,806,851,725,126,508,217,Metro,2022-07-14
2020-11-24,Northeast,1078,574,504,452,122,125,100,25,59,41,Greater MN,2022-07-14
2020-11-24,Northwest,343,203,140,155,48,38,30,8,12,18,Greater MN,2022-07-14
2020-11-24,South Central,436,238,198,175,63,29,18,11,6,12,Greater MN,2022-07-14
2020-11-24,Southeast,1337,854,483,747,107,254,154,100,126,28,Greater MN,2022-07-14
2020-11-24,Southwest,392,178,214,121,57,14,3,11,2,1,Greater MN,2022-07-14
2020-11-24,State,8810,6533,2277,5104,1429,1479,1148,331,763,385,State,2022-07-14
2020-11-24,West Central,205,99,106,71,28,20,8,12,7,1,Greater MN,2022-07-14
2021-11-24,Central,817,711,106,527,184,116,109,7,60,49,Greater MN,2022-07-14
2021-11-24,Metro,4296,4057,239,3456,601,874,776,98,593,183,Metro,2022-07-14
2021-11-24,Northeast,940,525,415,421,104,121,100,21,67,33,Greater MN,2022-07-14
2021-11-24,Northwest,351,203,148,153,50,30,18,12,5,13,Greater MN,2022-07-14
2021-11-24,South Central,365,230,135,181,49,22,11,11,6,5,Greater MN,2022-07-14
2021-11-24,Southeast,1319,1089,230,992,97,256,190,66,152,38,Greater MN,2022-07-14
2021-11-24,Southwest,388,148,240,121,27,12,6,6,2,4,Greater MN,2022-07-14
2021-11-24,State,8718,7113,1605,5971,1142,1449,1216,233,886,330,State,2022-07-14
2021-11-24,West Central,242,150,92,120,30,18,6,12,1,5,Greater MN,2022-07-14
2020-11-25,Central,810,662,148,463,199,131,104,27,45,59,Greater MN,2022-07-14
2020-11-25,Metro,4111,3720,391,2938,782,872,737,135,523,214,Metro,2022-07-14
2020-11-25,Northeast,1075,590,485,455,135,106,86,20,46,40,Greater MN,2022-07-14
2020-11-25,Northwest,373,209,164,159,50,39,28,11,13,15,Greater MN,2022-07-14
2020-11-25,South Central,416,224,192,155,69,29,17,12,6,11,Greater MN,2022-07-14
2020-11-25,Southeast,1356,926,430,827,99,253,170,83,135,35,Greater MN,2022-07-14
2020-11-25,Southwest,394,179,215,120,59,14,5,9,3,2,Greater MN,2022-07-14
2020-11-25,State,8772,6639,2133,5221,1418,1464,1155,309,777,378,State,2022-07-14
2020-11-25,West Central,237,129,108,104,25,20,8,12,6,2,Greater MN,2022-07-14
2021-11-25,Central,746,633,113,453,180,118,111,7,56,55,Greater MN,2022-07-14
2021-11-25,Metro,4055,3730,325,3114,616,872,769,103,589,180,Metro,2022-07-14
2021-11-25,Northeast,943,511,432,411,100,122,99,23,71,28,Greater MN,2022-07-14
2021-11-25,Northwest,333,165,168,124,41,32,20,12,5,15,Greater MN,2022-07-14
2021-11-25,South Central,359,232,127,186,46,22,9,13,4,5,Greater MN,2022-07-14
2021-11-25,Southeast,1317,1030,287,938,92,253,178,75,140,38,Greater MN,2022-07-14
2021-11-25,Southwest,369,113,256,88,25,11,6,5,2,4,Greater MN,2022-07-14
2021-11-25,State,8333,6517,1816,5391,1126,1447,1198,249,869,329,State,2022-07-14
2021-11-25,West Central,211,103,108,77,26,17,6,11,2,4,Greater MN,2022-07-14
2020-11-26,Central,740,584,156,399,185,134,104,30,43,61,Greater MN,2022-07-14
2020-11-26,Metro,3796,3317,479,2562,755,856,732,124,514,218,Metro,2022-07-14
2020-11-26,Northeast,1075,564,511,423,141,104,82,22,44,38,Greater MN,2022-07-14
2020-11-26,Northwest,357,188,169,138,50,39,28,11,14,14,Greater MN,2022-07-14
2020-11-26,South Central,411,208,203,141,67,28,15,13,5,10,Greater MN,2022-07-14
2020-11-26,Southeast,1341,878,463,768,110,251,162,89,126,36,Greater MN,2022-07-14
2020-11-26,Southwest,377,176,201,114,62,15,6,9,3,3,Greater MN,2022-07-14
2020-11-26,State,8302,6017,2285,4621,1396,1447,1140,307,758,382,State,2022-07-14
2020-11-26,West Central,205,102,103,76,26,20,11,9,9,2,Greater MN,2022-07-14
2021-11-26,Central,731,595,136,421,174,121,115,6,58,57,Greater MN,2022-07-14
2021-11-26,Metro,3880,3640,240,3011,629,861,763,98,571,192,Metro,2022-07-14
2021-11-26,Northeast,915,499,416,403,96,122,95,27,69,26,Greater MN,2022-07-14
2021-11-26,Northwest,334,154,180,113,41,31,19,12,4,15,Greater MN,2022-07-14
2021-11-26,South Central,358,227,131,177,50,22,9,13,5,4,Greater MN,2022-07-14
2021-11-26,Southeast,1308,932,376,840,92,253,163,90,125,38,Greater MN,2022-07-14
2021-11-26,Southwest,369,116,253,90,26,11,7,4,2,5,Greater MN,2022-07-14
2021-11-26,State,8106,6256,1850,5125,1131,1438,1179,259,838,341,State,2022-07-14
2021-11-26,West Central,211,93,118,70,23,17,8,9,4,4,Greater MN,2022-07-14
2020-11-27,Central,777,618,159,419,199,131,100,31,41,59,Greater MN,2022-07-14
2020-11-27,Metro,3741,3281,460,2574,707,834,703,131,480,223,Metro,2022-07-14
2020-11-27,Northeast,1071,559,512,413,146,110,93,17,49,44,Greater MN,2022-07-14
2020-11-27,Northwest,357,181,176,137,44,39,29,10,14,15,Greater MN,2022-07-14
2020-11-27,South Central,396,208,188,138,70,23,11,12,2,9,Greater MN,2022-07-14
2020-11-27,Southeast,1325,846,479,735,111,253,152,101,116,36,Greater MN,2022-07-14
2020-11-27,Southwest,379,159,220,104,55,15,5,10,2,3,Greater MN,2022-07-14
2020-11-27,State,8251,5943,2308,4583,1360,1425,1103,322,711,392,State,2022-07-14
2020-11-27,West Central,205,91,114,63,28,20,10,10,7,3,Greater MN,2022-07-14
2021-11-27,Central,756,642,114,475,167,127,122,5,59,63,Greater MN,2022-07-14
2021-11-27,Metro,3900,3628,272,2978,650,856,757,99,571,186,Metro,2022-07-14
2021-11-27,Northeast,911,504,407,412,92,119,85,34,60,25,Greater MN,2022-07-14
2021-11-27,Northwest,332,150,182,111,39,33,21,12,7,14,Greater MN,2022-07-14
2021-11-27,South Central,362,241,121,188,53,22,10,12,5,5,Greater MN,2022-07-14
2021-11-27,Southeast,1307,912,395,823,89,248,168,80,127,41,Greater MN,2022-07-14
2021-11-27,Southwest,370,117,253,89,28,11,6,5,1,5,Greater MN,2022-07-14
2021-11-27,State,8150,6300,1850,5156,1144,1433,1177,256,836,341,State,2022-07-14
2021-11-27,West Central,212,106,106,80,26,17,8,9,6,2,Greater MN,2022-07-14
2020-11-28,Central,775,606,169,410,196,131,101,30,45,56,Greater MN,2022-07-14
2020-11-28,Metro,3797,3378,419,2574,804,841,688,153,461,227,Metro,2022-07-14
2020-11-28,Northeast,1069,547,522,403,144,111,78,33,40,38,Greater MN,2022-07-14
2020-11-28,Northwest,361,173,188,133,40,35,21,14,12,9,Greater MN,2022-07-14
2020-11-28,South Central,410,216,194,149,67,29,16,13,3,13,Greater MN,2022-07-14
2020-11-28,Southeast,1330,854,476,747,107,252,164,88,130,34,Greater MN,2022-07-14
2020-11-28,Southwest,374,155,219,92,63,15,5,10,2,3,Greater MN,2022-07-14
2020-11-28,State,8321,6023,2298,4574,1449,1434,1081,353,700,381,State,2022-07-14
2020-11-28,West Central,205,94,111,66,28,20,8,12,7,1,Greater MN,2022-07-14
2021-11-28,Central,747,631,116,485,146,123,115,8,56,59,Greater MN,2022-07-14
2021-11-28,Metro,3899,3629,270,2951,678,852,742,110,558,184,Metro,2022-07-14
2021-11-28,Northeast,907,517,390,414,103,121,89,32,60,29,Greater MN,2022-07-14
2021-11-28,Northwest,333,158,175,119,39,32,19,13,6,13,Greater MN,2022-07-14
2021-11-28,South Central,363,244,119,188,56,22,11,11,6,5,Greater MN,2022-07-14
2021-11-28,Southeast,1302,919,383,835,84,250,181,69,135,46,Greater MN,2022-07-14
2021-11-28,Southwest,371,122,249,92,30,11,6,5,1,5,Greater MN,2022-07-14
2021-11-28,State,8134,6327,1807,5163,1164,1428,1170,258,828,342,State,2022-07-14
2021-11-28,West Central,212,107,105,79,28,17,7,10,6,1,Greater MN,2022-07-14
2020-11-29,Central,750,568,182,374,194,129,95,34,44,51,Greater MN,2022-07-14
2020-11-29,Metro,3791,3364,427,2548,816,848,712,136,481,231,Metro,2022-07-14
2020-11-29,Northeast,1071,518,553,376,142,110,92,18,46,46,Greater MN,2022-07-14
2020-11-29,Northwest,361,174,187,124,50,35,24,11,12,12,Greater MN,2022-07-14
2020-11-29,South Central,409,219,190,154,65,28,15,13,3,12,Greater MN,2022-07-14
2020-11-29,Southeast,1319,799,520,690,109,251,153,98,117,36,Greater MN,2022-07-14
2020-11-29,Southwest,381,163,218,98,65,16,5,11,2,3,Greater MN,2022-07-14
2020-11-29,State,8287,5891,2396,4420,1471,1437,1107,330,714,393,State,2022-07-14
2020-11-29,West Central,205,86,119,56,30,20,11,9,9,2,Greater MN,2022-07-14
2021-11-29,Central,779,678,101,510,168,121,113,8,52,61,Greater MN,2022-07-14
2021-11-29,Metro,3907,3679,228,2992,687,856,729,127,543,186,Metro,2022-07-14
2021-11-29,Northeast,917,514,403,422,92,120,87,33,60,27,Greater MN,2022-07-14
2021-11-29,Northwest,333,176,157,135,41,32,17,15,6,11,Greater MN,2022-07-14
2021-11-29,South Central,364,245,119,194,51,22,11,11,5,6,Greater MN,2022-07-14
2021-11-29,Southeast,1292,947,345,856,91,253,171,82,124,47,Greater MN,2022-07-14
2021-11-29,Southwest,370,129,241,100,29,11,6,5,2,4,Greater MN,2022-07-14
2021-11-29,State,8174,6475,1699,5285,1190,1432,1140,292,797,343,State,2022-07-14
2021-11-29,West Central,212,107,105,76,31,17,6,11,5,1,Greater MN,2022-07-14
2020-11-30,Central,756,577,179,374,203,127,94,33,46,48,Greater MN,2022-07-14
2020-11-30,Metro,3782,3326,456,2521,805,819,695,124,464,231,Metro,2022-07-14
2020-11-30,Northeast,1082,565,517,435,130,110,81,29,31,50,Greater MN,2022-07-14
2020-11-30,Northwest,361,178,183,127,51,35,25,10,10,15,Greater MN,2022-07-14
2020-11-30,South Central,419,226,193,161,65,28,14,14,5,9,Greater MN,2022-07-14
2020-11-30,Southeast,1320,793,527,684,109,251,156,95,119,37,Greater MN,2022-07-14
2020-11-30,Southwest,376,163,213,99,64,16,4,12,2,2,Greater MN,2022-07-14
2020-11-30,State,8301,5924,2377,4470,1454,1406,1079,327,685,394,State,2022-07-14
2020-11-30,West Central,205,96,109,69,27,20,10,10,8,2,Greater MN,2022-07-14
2021-11-30,Central,780,686,94,516,170,123,115,8,51,64,Greater MN,2022-07-14
2021-11-30,Metro,4068,3859,209,3163,696,862,754,108,558,196,Metro,2022-07-14
2021-11-30,Northeast,929,551,378,453,98,123,88,35,63,25,Greater MN,2022-07-14
2021-11-30,Northwest,335,185,150,142,43,31,21,10,10,11,Greater MN,2022-07-14
2021-11-30,South Central,367,259,108,204,55,22,11,11,5,6,Greater MN,2022-07-14
2021-11-30,Southeast,1309,1048,261,956,92,252,187,65,139,48,Greater MN,2022-07-14
2021-11-30,Southwest,369,140,229,116,24,13,7,6,2,5,Greater MN,2022-07-14
2021-11-30,State,8369,6844,1525,5638,1206,1443,1189,254,833,356,State,2022-07-14
2021-11-30,West Central,212,116,96,88,28,17,6,11,5,1,Greater MN,2022-07-14
2020-12-01,Central,800,632,168,459,173,125,92,33,41,51,Greater MN,2022-07-14
2020-12-01,Metro,3895,3459,436,2651,808,867,749,118,516,233,Metro,2022-07-14
2020-12-01,Northeast,1035,525,510,413,112,108,84,24,45,39,Greater MN,2022-07-14
2020-12-01,Northwest,360,179,181,128,51,36,25,11,10,15,Greater MN,2022-07-14
2020-12-01,South Central,420,252,168,190,62,25,12,13,6,6,Greater MN,2022-07-14
2020-12-01,Southeast,1335,835,500,734,101,252,168,84,133,35,Greater MN,2022-07-14
2020-12-01,Southwest,380,184,196,130,54,15,4,11,-12,16,Greater MN,2022-07-14
2020-12-01,State,8430,6168,2262,4786,1382,1448,1144,304,745,399,State,2022-07-14
2020-12-01,West Central,205,102,103,81,21,20,10,10,6,4,Greater MN,2022-07-14
2021-12-01,Central,834,729,105,545,184,121,114,7,53,61,Greater MN,2022-07-14
2021-12-01,Metro,4248,4048,200,3371,677,867,771,96,585,186,Metro,2022-07-14
2021-12-01,Northeast,931,566,365,466,100,124,95,29,72,23,Greater MN,2022-07-14
2021-12-01,Northwest,351,203,148,163,40,30,21,9,9,12,Greater MN,2022-07-14
2021-12-01,South Central,366,255,111,198,57,22,12,10,6,6,Greater MN,2022-07-14
2021-12-01,Southeast,1333,1123,210,1025,98,250,179,71,130,49,Greater MN,2022-07-14
2021-12-01,Southwest,389,172,217,145,27,13,6,7,1,5,Greater MN,2022-07-14
2021-12-01,State,8696,7237,1459,6033,1204,1444,1208,236,863,345,State,2022-07-14
2021-12-01,West Central,244,141,103,120,21,17,10,7,7,3,Greater MN,2022-07-14
2020-12-02,Central,825,643,182,453,190,124,91,33,47,44,Greater MN,2022-07-14
2020-12-02,Metro,4162,3843,319,3041,802,858,726,132,488,238,Metro,2022-07-14
2020-12-02,Northeast,1097,583,514,468,115,108,76,32,39,37,Greater MN,2022-07-14
2020-12-02,Northwest,383,204,179,156,48,35,21,14,8,13,Greater MN,2022-07-14
2020-12-02,South Central,422,249,173,181,68,26,13,13,7,6,Greater MN,2022-07-14
2020-12-02,Southeast,1346,901,445,801,100,261,172,89,139,33,Greater MN,2022-07-14
2020-12-02,Southwest,392,182,210,128,54,13,1,12,0,1,Greater MN,2022-07-14
2020-12-02,State,8864,6734,2130,5338,1396,1445,1109,336,733,376,State,2022-07-14
2020-12-02,West Central,237,129,108,110,19,20,9,11,5,4,Greater MN,2022-07-14
2021-12-02,Central,820,715,105,530,185,121,116,5,54,62,Greater MN,2022-07-14
2021-12-02,Metro,4072,3864,208,3179,685,865,773,92,586,187,Metro,2022-07-14
2021-12-02,Northeast,931,554,377,454,100,124,94,30,72,22,Greater MN,2022-07-14
2021-12-02,Northwest,334,190,144,151,39,31,22,9,8,14,Greater MN,2022-07-14
2021-12-02,South Central,366,249,117,192,57,22,12,10,4,8,Greater MN,2022-07-14
2021-12-02,Southeast,1308,1145,163,1052,93,252,197,55,148,49,Greater MN,2022-07-14
2021-12-02,Southwest,385,166,219,141,25,12,7,5,1,6,Greater MN,2022-07-14
2021-12-02,State,8427,7004,1423,5795,1209,1444,1230,214,877,353,State,2022-07-14
2021-12-02,West Central,211,121,90,96,25,17,9,8,4,5,Greater MN,2022-07-14
2020-12-03,Central,762,603,159,441,162,127,93,34,47,46,Greater MN,2022-07-14
2020-12-03,Metro,3990,3640,350,2878,762,846,724,122,492,232,Metro,2022-07-14
2020-12-03,Northeast,1036,536,500,427,109,106,82,24,48,34,Greater MN,2022-07-14
2020-12-03,Northwest,367,195,172,147,48,35,23,12,8,15,Greater MN,2022-07-14
2020-12-03,South Central,424,251,173,186,65,28,15,13,7,8,Greater MN,2022-07-14
2020-12-03,Southeast,1334,905,429,806,99,259,170,89,142,28,Greater MN,2022-07-14
2020-12-03,Southwest,382,174,208,124,50,13,1,12,0,1,Greater MN,2022-07-14
2020-12-03,State,8516,6407,2109,5095,1312,1434,1117,317,749,368,State,2022-07-14
2020-12-03,West Central,221,103,118,86,17,20,9,11,5,4,Greater MN,2022-07-14
2021-12-03,Central,819,703,116,515,188,117,108,9,50,58,Greater MN,2022-07-14
2021-12-03,Metro,4099,3884,215,3191,693,865,775,90,596,179,Metro,2022-07-14
2021-12-03,Northeast,930,526,404,441,85,124,96,28,67,29,Greater MN,2022-07-14
2021-12-03,Northwest,334,200,134,160,40,29,20,9,8,12,Greater MN,2022-07-14
2021-12-03,South Central,363,248,115,190,58,22,12,10,4,8,Greater MN,2022-07-14
2021-12-03,Southeast,1323,1138,185,1038,100,252,197,55,147,50,Greater MN,2022-07-14
2021-12-03,Southwest,385,157,228,125,32,11,6,5,1,5,Greater MN,2022-07-14
2021-12-03,State,8464,6960,1504,5736,1224,1437,1225,212,879,346,State,2022-07-14
2021-12-03,West Central,211,104,107,76,28,17,11,6,6,5,Greater MN,2022-07-14
2020-12-04,Central,766,609,157,459,150,126,92,34,45,47,Greater MN,2022-07-14
2020-12-04,Metro,3963,3617,346,2874,743,843,721,122,491,230,Metro,2022-07-14
2020-12-04,Northeast,1042,555,487,455,100,105,80,25,47,33,Greater MN,2022-07-14
2020-12-04,Northwest,367,197,170,150,47,35,21,14,7,14,Greater MN,2022-07-14
2020-12-04,South Central,421,240,181,180,60,29,13,16,6,7,Greater MN,2022-07-14
2020-12-04,Southeast,1334,938,396,843,95,260,158,102,129,29,Greater MN,2022-07-14
2020-12-04,Southwest,369,168,201,116,52,15,3,12,2,1,Greater MN,2022-07-14
2020-12-04,State,8467,6410,2057,5148,1262,1433,1096,337,733,363,State,2022-07-14
2020-12-04,West Central,205,86,119,71,15,20,8,12,6,2,Greater MN,2022-07-14
2021-12-04,Central,790,658,132,471,187,114,108,6,51,57,Greater MN,2022-07-14
2021-12-04,Metro,4123,3881,242,3167,714,848,752,96,572,180,Metro,2022-07-14
2021-12-04,Northeast,941,500,441,409,91,123,99,24,70,29,Greater MN,2022-07-14
2021-12-04,Northwest,334,190,144,156,34,30,19,11,10,9,Greater MN,2022-07-14
2021-12-04,South Central,363,251,112,192,59,22,12,10,5,7,Greater MN,2022-07-14
2021-12-04,Southeast,1321,1116,205,1013,103,253,203,50,155,48,Greater MN,2022-07-14
2021-12-04,Southwest,378,144,234,117,27,11,5,6,0,5,Greater MN,2022-07-14
2021-12-04,State,8461,6833,1628,5596,1237,1418,1205,213,866,339,State,2022-07-14
2021-12-04,West Central,211,93,118,71,22,17,7,10,3,4,Greater MN,2022-07-14
2020-12-05,Central,776,625,151,479,146,126,91,35,48,43,Greater MN,2022-07-14
2020-12-05,Metro,3934,3515,419,2793,722,857,726,131,493,233,Metro,2022-07-14
2020-12-05,Northeast,1044,531,513,428,103,103,76,27,45,31,Greater MN,2022-07-14
2020-12-05,Northwest,368,192,176,145,47,35,24,11,10,14,Greater MN,2022-07-14
2020-12-05,South Central,419,223,196,162,61,28,13,15,5,8,Greater MN,2022-07-14
2020-12-05,Southeast,1335,903,432,818,85,262,153,109,126,27,Greater MN,2022-07-14
2020-12-05,Southwest,366,143,223,94,49,14,4,10,1,3,Greater MN,2022-07-14
2020-12-05,State,8447,6217,2230,4988,1229,1445,1091,354,731,360,State,2022-07-14
2020-12-05,West Central,205,85,120,69,16,20,4,16,3,1,Greater MN,2022-07-14
2021-12-05,Central,756,622,134,446,176,111,104,7,47,57,Greater MN,2022-07-14
2021-12-05,Metro,4025,3743,282,3023,720,840,751,89,571,180,Metro,2022-07-14
2021-12-05,Northeast,941,493,448,402,91,122,98,24,64,34,Greater MN,2022-07-14
2021-12-05,Northwest,334,171,163,136,35,30,17,13,8,9,Greater MN,2022-07-14
2021-12-05,South Central,363,239,124,183,56,23,12,11,5,7,Greater MN,2022-07-14
2021-12-05,Southeast,1316,1033,283,925,108,253,193,60,146,47,Greater MN,2022-07-14
2021-12-05,Southwest,374,130,244,102,28,11,4,7,0,4,Greater MN,2022-07-14
2021-12-05,State,8320,6524,1796,5289,1235,1407,1185,222,844,341,State,2022-07-14
2021-12-05,West Central,211,93,118,72,21,17,6,11,3,3,Greater MN,2022-07-14
2020-12-06,Central,760,585,175,438,147,123,86,37,44,42,Greater MN,2022-07-14
2020-12-06,Metro,3817,3399,418,2690,709,838,694,144,469,225,Metro,2022-07-14
2020-12-06,Northeast,1041,501,540,392,109,103,74,29,42,32,Greater MN,2022-07-14
2020-12-06,Northwest,353,178,175,130,48,35,23,12,10,13,Greater MN,2022-07-14
2020-12-06,South Central,416,221,195,153,68,28,14,14,5,9,Greater MN,2022-07-14
2020-12-06,Southeast,1325,816,509,724,92,259,135,124,110,25,Greater MN,2022-07-14
2020-12-06,Southwest,372,149,223,106,43,14,4,10,1,3,Greater MN,2022-07-14
2020-12-06,State,8289,5929,2360,4699,1230,1420,1034,386,684,350,State,2022-07-14
2020-12-06,West Central,205,80,125,66,14,20,4,16,3,1,Greater MN,2022-07-14
2021-12-06,Central,776,647,129,459,188,117,110,7,50,60,Greater MN,2022-07-14
2021-12-06,Metro,3985,3772,213,3027,745,835,743,92,565,178,Metro,2022-07-14
2021-12-06,Northeast,940,484,456,396,88,124,96,28,59,37,Greater MN,2022-07-14
2021-12-06,Northwest,335,173,162,134,39,28,19,9,12,7,Greater MN,2022-07-14
2021-12-06,South Central,362,248,114,184,64,23,12,11,5,7,Greater MN,2022-07-14
2021-12-06,Southeast,1305,1018,287,911,107,253,179,74,137,42,Greater MN,2022-07-14
2021-12-06,Southwest,376,142,234,108,34,11,3,8,1,2,Greater MN,2022-07-14
2021-12-06,State,8290,6582,1708,5291,1291,1408,1171,237,836,335,State,2022-07-14
2021-12-06,West Central,211,98,113,72,26,17,9,8,7,2,Greater MN,2022-07-14
2020-12-07,Central,725,590,135,435,155,125,85,40,41,44,Greater MN,2022-07-14
2020-12-07,Metro,3785,3387,398,2680,707,838,708,130,478,230,Metro,2022-07-14
2020-12-07,Northeast,952,513,439,405,108,118,82,36,48,34,Greater MN,2022-07-14
2020-12-07,Northwest,322,190,132,138,52,33,23,10,10,13,Greater MN,2022-07-14
2020-12-07,South Central,411,228,183,160,68,29,16,13,9,7,Greater MN,2022-07-14
2020-12-07,Southeast,1318,796,522,710,86,260,135,125,109,26,Greater MN,2022-07-14
2020-12-07,Southwest,368,154,214,110,44,14,4,10,1,3,Greater MN,2022-07-14
2020-12-07,State,8086,5944,2142,4709,1235,1437,1057,380,700,357,State,2022-07-14
2020-12-07,West Central,205,86,119,71,15,20,4,16,4,0,Greater MN,2022-07-14
2021-12-07,Central,795,677,118,482,195,124,116,8,54,62,Greater MN,2022-07-14
2021-12-07,Metro,4083,3879,204,3122,757,833,747,86,566,181,Metro,2022-07-14
2021-12-07,Northeast,910,535,375,437,98,115,82,33,56,26,Greater MN,2022-07-14
2021-12-07,Northwest,336,190,146,154,36,29,20,9,11,9,Greater MN,2022-07-14
2021-12-07,South Central,363,248,115,179,69,22,12,10,5,7,Greater MN,2022-07-14
2021-12-07,Southeast,1305,1075,230,968,107,250,190,60,157,33,Greater MN,2022-07-14
2021-12-07,Southwest,375,142,233,110,32,11,4,7,2,2,Greater MN,2022-07-14
2021-12-07,State,8379,6854,1525,5531,1323,1401,1177,224,856,321,State,2022-07-14
2021-12-07,West Central,212,108,104,79,29,17,6,11,5,1,Greater MN,2022-07-14
2020-12-08,Central,755,636,119,485,151,120,76,44,34,42,Greater MN,2022-07-14
2020-12-08,Metro,3911,3514,397,2819,695,848,722,126,492,230,Metro,2022-07-14
2020-12-08,Northeast,957,514,443,418,96,120,88,32,58,30,Greater MN,2022-07-14
2020-12-08,Northwest,321,193,128,145,48,34,25,9,11,14,Greater MN,2022-07-14
2020-12-08,South Central,416,222,194,164,58,28,13,15,7,6,Greater MN,2022-07-14
2020-12-08,Southeast,1306,868,438,784,84,257,158,99,131,27,Greater MN,2022-07-14
2020-12-08,Southwest,367,146,221,102,44,16,5,11,0,5,Greater MN,2022-07-14
2020-12-08,State,8238,6200,2038,5011,1189,1443,1091,352,736,355,State,2022-07-14
2020-12-08,West Central,205,107,98,94,13,20,4,16,3,1,Greater MN,2022-07-14
2021-12-08,Central,806,690,116,494,196,126,119,7,53,66,Greater MN,2022-07-14
2021-12-08,Metro,4291,4079,212,3339,740,856,757,99,570,187,Metro,2022-07-14
2021-12-08,Northeast,941,560,381,461,99,115,88,27,63,25,Greater MN,2022-07-14
2021-12-08,Northwest,313,210,103,174,36,30,22,8,10,12,Greater MN,2022-07-14
2021-12-08,South Central,368,242,126,174,68,22,10,12,5,5,Greater MN,2022-07-14
2021-12-08,Southeast,1336,1107,229,990,117,254,195,59,163,32,Greater MN,2022-07-14
2021-12-08,Southwest,392,160,232,131,29,11,6,5,4,2,Greater MN,2022-07-14
2021-12-08,State,8690,7195,1495,5872,1323,1431,1203,228,873,330,State,2022-07-14
2021-12-08,West Central,243,147,96,109,38,17,6,11,5,1,Greater MN,2022-07-14
2020-12-09,Central,790,665,125,517,148,121,80,41,36,44,Greater MN,2022-07-14
2020-12-09,Metro,4139,3734,405,3026,708,870,745,125,523,222,Metro,2022-07-14
2020-12-09,Northeast,951,528,423,431,97,121,94,27,59,35,Greater MN,2022-07-14
2020-12-09,Northwest,342,205,137,153,52,32,24,8,12,12,Greater MN,2022-07-14
2020-12-09,South Central,413,225,188,171,54,27,13,14,9,4,Greater MN,2022-07-14
2020-12-09,Southeast,1349,892,457,816,76,257,158,99,132,26,Greater MN,2022-07-14
2020-12-09,Southwest,386,165,221,122,43,16,5,11,1,4,Greater MN,2022-07-14
2020-12-09,State,8607,6535,2072,5343,1192,1464,1127,337,778,349,State,2022-07-14
2020-12-09,West Central,237,121,116,107,14,20,8,12,6,2,Greater MN,2022-07-14
2021-12-09,Central,762,632,130,441,191,120,113,7,51,62,Greater MN,2022-07-14
2021-12-09,Metro,4091,3890,201,3125,765,846,754,92,560,194,Metro,2022-07-14
2021-12-09,Northeast,940,572,368,467,105,113,88,25,64,24,Greater MN,2022-07-14
2021-12-09,Northwest,302,206,96,173,33,31,23,8,12,11,Greater MN,2022-07-14
2021-12-09,South Central,368,247,121,181,66,22,12,10,7,5,Greater MN,2022-07-14
2021-12-09,Southeast,1307,1105,202,994,111,253,196,57,159,37,Greater MN,2022-07-14
2021-12-09,Southwest,382,167,215,136,31,12,5,7,2,3,Greater MN,2022-07-14
2021-12-09,State,8362,6932,1430,5592,1340,1415,1199,216,861,338,State,2022-07-14
2021-12-09,West Central,210,113,97,75,38,18,8,10,6,2,Greater MN,2022-07-14
2020-12-10,Central,743,619,124,484,135,124,82,42,35,47,Greater MN,2022-07-14
2020-12-10,Metro,4002,3646,356,2940,706,875,744,131,536,208,Metro,2022-07-14
2020-12-10,Northeast,953,545,408,457,88,120,91,29,56,35,Greater MN,2022-07-14
2020-12-10,Northwest,326,199,127,146,53,34,23,11,10,13,Greater MN,2022-07-14
2020-12-10,South Central,416,230,186,181,49,28,13,15,6,7,Greater MN,2022-07-14
2020-12-10,Southeast,1351,926,425,857,69,261,156,105,129,27,Greater MN,2022-07-14
2020-12-10,Southwest,375,173,202,132,41,15,6,9,2,4,Greater MN,2022-07-14
2020-12-10,State,8371,6436,1935,5281,1155,1477,1124,353,781,343,State,2022-07-14
2020-12-10,West Central,205,98,107,84,14,20,9,11,7,2,Greater MN,2022-07-14
2021-12-10,Central,760,644,116,460,184,118,110,8,47,63,Greater MN,2022-07-14
2021-12-10,Metro,4072,3808,264,3017,791,834,745,89,551,194,Metro,2022-07-14
2021-12-10,Northeast,927,559,368,462,97,114,87,27,62,25,Greater MN,2022-07-14
2021-12-10,Northwest,298,197,101,166,31,30,20,10,10,10,Greater MN,2022-07-14
2021-12-10,South Central,366,247,119,181,66,22,11,11,7,4,Greater MN,2022-07-14
2021-12-10,Southeast,1323,1087,236,988,99,252,199,53,157,42,Greater MN,2022-07-14
2021-12-10,Southwest,374,155,219,125,30,12,5,7,2,3,Greater MN,2022-07-14
2021-12-10,State,8331,6806,1525,5470,1336,1399,1185,214,841,344,State,2022-07-14
2021-12-10,West Central,211,109,102,71,38,17,8,9,5,3,Greater MN,2022-07-14
2020-12-11,Central,770,644,126,514,130,120,78,42,33,45,Greater MN,2022-07-14
2020-12-11,Metro,3985,3600,385,2978,622,863,744,119,529,215,Metro,2022-07-14
2020-12-11,Northeast,963,541,422,459,82,117,86,31,54,32,Greater MN,2022-07-14
2020-12-11,Northwest,326,196,130,142,54,36,21,15,9,12,Greater MN,2022-07-14
2020-12-11,South Central,416,222,194,169,53,27,12,15,6,6,Greater MN,2022-07-14
2020-12-11,Southeast,1337,910,427,841,69,263,157,106,131,26,Greater MN,2022-07-14
2020-12-11,Southwest,359,159,200,116,43,14,3,11,0,3,Greater MN,2022-07-14
2020-12-11,State,8361,6375,1986,5309,1066,1460,1107,353,767,340,State,2022-07-14
2020-12-11,West Central,205,103,102,90,13,20,6,14,5,1,Greater MN,2022-07-14
2021-12-11,Central,764,636,128,475,161,122,117,5,53,64,Greater MN,2022-07-14
2021-12-11,Metro,4042,3800,242,3029,771,832,743,89,546,197,Metro,2022-07-14
2021-12-11,Northeast,934,540,394,442,98,114,90,24,64,26,Greater MN,2022-07-14
2021-12-11,Northwest,294,183,111,150,33,30,23,7,14,9,Greater MN,2022-07-14
2021-12-11,South Central,362,237,125,181,56,22,14,8,8,6,Greater MN,2022-07-14
2021-12-11,Southeast,1321,1077,244,986,91,251,190,61,151,39,Greater MN,2022-07-14
2021-12-11,Southwest,367,145,222,114,31,13,7,6,4,3,Greater MN,2022-07-14
2021-12-11,State,8295,6715,1580,5437,1278,1401,1192,209,846,346,State,2022-07-14
2021-12-11,West Central,211,97,114,60,37,17,8,9,6,2,Greater MN,2022-07-14
2020-12-12,Central,772,623,149,511,112,127,87,40,39,48,Greater MN,2022-07-14
2020-12-12,Metro,3930,3427,503,2833,594,861,729,132,526,203,Metro,2022-07-14
2020-12-12,Northeast,963,510,453,418,92,112,82,30,53,29,Greater MN,2022-07-14
2020-12-12,Northwest,331,173,158,124,49,29,18,11,8,10,Greater MN,2022-07-14
2020-12-12,South Central,413,224,189,170,54,24,9,15,6,3,Greater MN,2022-07-14
2020-12-12,Southeast,1379,872,507,807,65,268,171,97,144,27,Greater MN,2022-07-14
2020-12-12,Southwest,354,141,213,98,43,14,3,11,1,2,Greater MN,2022-07-14
2020-12-12,State,8347,6062,2285,5044,1018,1455,1107,348,784,323,State,2022-07-14
2020-12-12,West Central,205,92,113,83,9,20,8,12,7,1,Greater MN,2022-07-14
2021-12-12,Central,757,627,130,454,173,116,110,6,50,60,Greater MN,2022-07-14
2021-12-12,Metro,3999,3761,238,2947,814,835,749,86,554,195,Metro,2022-07-14
2021-12-12,Northeast,933,529,404,440,89,114,95,19,67,28,Greater MN,2022-07-14
2021-12-12,Northwest,297,180,117,148,32,29,21,8,13,8,Greater MN,2022-07-14
2021-12-12,South Central,366,224,142,166,58,22,14,8,7,7,Greater MN,2022-07-14
2021-12-12,Southeast,1306,1027,279,946,81,252,175,77,133,42,Greater MN,2022-07-14
2021-12-12,Southwest,371,140,231,111,29,12,7,5,3,4,Greater MN,2022-07-14
2021-12-12,State,8240,6566,1674,5261,1305,1397,1180,217,834,346,State,2022-07-14
2021-12-12,West Central,211,78,133,49,29,17,9,8,7,2,Greater MN,2022-07-14
2020-12-13,Central,741,576,165,468,108,125,82,43,34,48,Greater MN,2022-07-14
2020-12-13,Metro,3812,3214,598,2644,570,846,696,150,493,203,Metro,2022-07-14
2020-12-13,Northeast,959,410,549,318,92,114,89,25,61,28,Greater MN,2022-07-14
2020-12-13,Northwest,329,164,165,123,41,29,16,13,8,8,Greater MN,2022-07-14
2020-12-13,South Central,413,206,207,157,49,24,11,13,5,6,Greater MN,2022-07-14
2020-12-13,Southeast,1376,809,567,748,61,269,146,123,122,24,Greater MN,2022-07-14
2020-12-13,Southwest,356,136,220,93,43,14,3,11,2,1,Greater MN,2022-07-14
2020-12-13,State,8191,5589,2602,4618,971,1441,1052,389,733,319,State,2022-07-14
2020-12-13,West Central,205,74,131,67,7,20,9,11,8,1,Greater MN,2022-07-14
2021-12-13,Central,772,657,115,479,178,115,111,4,46,65,Greater MN,2022-07-14
2021-12-13,Metro,4029,3775,254,2989,786,837,748,89,548,200,Metro,2022-07-14
2021-12-13,Northeast,942,547,395,460,87,104,86,18,63,23,Greater MN,2022-07-14
2021-12-13,Northwest,295,181,114,149,32,30,19,11,11,8,Greater MN,2022-07-14
2021-12-13,South Central,366,238,128,182,56,22,10,12,6,4,Greater MN,2022-07-14
2021-12-13,Southeast,1314,1023,291,932,91,254,174,80,129,45,Greater MN,2022-07-14
2021-12-13,Southwest,368,137,231,104,33,13,8,5,3,5,Greater MN,2022-07-14
2021-12-13,State,8297,6640,1657,5352,1288,1392,1163,229,811,352,State,2022-07-14
2021-12-13,West Central,211,82,129,57,25,17,7,10,5,2,Greater MN,2022-07-14
2020-12-14,Central,741,575,166,473,102,127,86,41,43,43,Greater MN,2022-07-14
2020-12-14,Metro,3754,3228,526,2630,598,831,706,125,508,198,Metro,2022-07-14
2020-12-14,Northeast,966,541,425,447,94,114,87,27,64,23,Greater MN,2022-07-14
2020-12-14,Northwest,328,166,162,126,40,29,15,14,9,6,Greater MN,2022-07-14
2020-12-14,South Central,419,223,196,168,55,24,10,14,4,6,Greater MN,2022-07-14
2020-12-14,Southeast,1376,793,583,727,66,270,146,124,122,24,Greater MN,2022-07-14
2020-12-14,Southwest,361,141,220,97,44,15,3,12,3,0,Greater MN,2022-07-14
2020-12-14,State,8150,5747,2403,4740,1007,1430,1061,369,761,300,State,2022-07-14
2020-12-14,West Central,205,80,125,72,8,20,8,12,8,0,Greater MN,2022-07-14
2021-12-14,Central,782,664,118,492,172,124,117,7,54,63,Greater MN,2022-07-14
2021-12-14,Metro,4121,3879,242,3085,794,838,739,99,529,210,Metro,2022-07-14
2021-12-14,Northeast,945,557,388,476,81,115,93,22,69,24,Greater MN,2022-07-14
2021-12-14,Northwest,297,184,113,153,31,30,19,11,8,11,Greater MN,2022-07-14
2021-12-14,South Central,361,252,109,197,55,22,11,11,7,4,Greater MN,2022-07-14
2021-12-14,Southeast,1321,1094,227,998,96,255,194,61,146,48,Greater MN,2022-07-14
2021-12-14,Southwest,377,152,225,127,25,13,9,4,3,6,Greater MN,2022-07-14
2021-12-14,State,8415,6876,1539,5603,1273,1414,1191,223,820,371,State,2022-07-14
2021-12-14,West Central,211,94,117,75,19,17,9,8,4,5,Greater MN,2022-07-14
2020-12-15,Central,749,594,155,492,102,128,88,40,44,44,Greater MN,2022-07-14
2020-12-15,Metro,3872,3381,491,2799,582,835,717,118,522,195,Metro,2022-07-14
2020-12-15,Northeast,965,557,408,475,82,114,84,30,57,27,Greater MN,2022-07-14
2020-12-15,Northwest,324,180,144,145,35,29,18,11,10,8,Greater MN,2022-07-14
2020-12-15,South Central,420,231,189,179,52,24,10,14,5,5,Greater MN,2022-07-14
2020-12-15,Southeast,1372,867,505,805,62,270,156,114,132,24,Greater MN,2022-07-14
2020-12-15,Southwest,361,144,217,97,47,15,4,11,3,1,Greater MN,2022-07-14
2020-12-15,State,8268,6049,2219,5076,973,1435,1087,348,783,304,State,2022-07-14
2020-12-15,West Central,205,95,110,84,11,20,10,10,10,0,Greater MN,2022-07-14
2021-12-15,Central,818,704,114,533,171,128,122,6,59,63,Greater MN,2022-07-14
2021-12-15,Metro,4299,4034,265,3298,736,837,742,95,535,207,Metro,2022-07-14
2021-12-15,Northeast,943,567,376,479,88,115,94,21,67,27,Greater MN,2022-07-14
2021-12-15,Northwest,313,200,113,172,28,29,19,10,8,11,Greater MN,2022-07-14
2021-12-15,South Central,365,259,106,212,47,22,10,12,7,3,Greater MN,2022-07-14
2021-12-15,Southeast,1329,1152,177,1063,89,257,186,71,135,51,Greater MN,2022-07-14
2021-12-15,Southwest,403,175,228,141,34,12,7,5,3,4,Greater MN,2022-07-14
2021-12-15,State,8713,7231,1482,6016,1215,1417,1189,228,820,369,State,2022-07-14
2021-12-15,West Central,243,140,103,118,22,17,9,8,6,3,Greater MN,2022-07-14
2020-12-16,Central,849,613,236,519,94,102,80,22,43,37,Greater MN,2022-07-14
2020-12-16,Metro,4086,3599,487,3011,588,843,724,119,537,187,Metro,2022-07-14
2020-12-16,Northeast,965,577,388,495,82,114,85,29,60,25,Greater MN,2022-07-14
2020-12-16,Northwest,341,183,158,153,30,28,14,14,8,6,Greater MN,2022-07-14
2020-12-16,South Central,419,223,196,176,47,26,11,15,6,5,Greater MN,2022-07-14
2020-12-16,Southeast,1392,901,491,849,52,270,161,109,140,21,Greater MN,2022-07-14
2020-12-16,Southwest,394,166,228,122,44,14,2,12,1,1,Greater MN,2022-07-14
2020-12-16,State,8683,6372,2311,5423,949,1417,1086,331,803,283,State,2022-07-14
2020-12-16,West Central,237,110,127,98,12,20,9,11,8,1,Greater MN,2022-07-14
2021-12-16,Central,751,643,108,484,159,126,118,8,56,62,Greater MN,2022-07-14
2021-12-16,Metro,4073,3841,232,3111,730,838,745,93,533,212,Metro,2022-07-14
2021-12-16,Northeast,952,562,390,478,84,115,92,23,66,26,Greater MN,2022-07-14
2021-12-16,Northwest,296,205,91,175,30,30,22,8,10,12,Greater MN,2022-07-14
2021-12-16,South Central,360,250,110,200,50,22,9,13,4,5,Greater MN,2022-07-14
2021-12-16,Southeast,1320,1132,188,1052,80,257,195,62,147,48,Greater MN,2022-07-14
2021-12-16,Southwest,384,175,209,148,27,13,7,6,1,6,Greater MN,2022-07-14
2021-12-16,State,8347,6921,1426,5739,1182,1418,1196,222,822,374,State,2022-07-14
2021-12-16,West Central,211,113,98,91,22,17,8,9,5,3,Greater MN,2022-07-14
2020-12-17,Central,820,592,228,499,93,104,81,23,47,34,Greater MN,2022-07-14
2020-12-17,Metro,3920,3490,430,2972,518,855,715,140,538,177,Metro,2022-07-14
2020-12-17,Northeast,957,562,395,481,81,114,84,30,57,27,Greater MN,2022-07-14
2020-12-17,Northwest,326,181,145,152,29,28,16,12,10,6,Greater MN,2022-07-14
2020-12-17,South Central,422,242,180,196,46,24,9,15,3,6,Greater MN,2022-07-14
2020-12-17,Southeast,1368,892,476,836,56,272,153,119,133,20,Greater MN,2022-07-14
2020-12-17,Southwest,370,144,226,104,40,12,1,11,1,0,Greater MN,2022-07-14
2020-12-17,State,8388,6189,2199,5313,876,1429,1065,364,795,270,State,2022-07-14
2020-12-17,West Central,205,86,119,73,13,20,6,14,6,0,Greater MN,2022-07-14
2021-12-17,Central,744,625,119,478,147,120,110,10,53,57,Greater MN,2022-07-14
2021-12-17,Metro,4033,3858,175,3157,701,831,744,87,534,210,Metro,2022-07-14
2021-12-17,Northeast,941,553,388,479,74,108,88,20,61,27,Greater MN,2022-07-14
2021-12-17,Northwest,294,193,101,162,31,29,21,8,8,13,Greater MN,2022-07-14
2021-12-17,South Central,358,242,116,189,53,24,12,12,6,6,Greater MN,2022-07-14
2021-12-17,Southeast,1315,1095,220,1018,77,256,197,59,154,43,Greater MN,2022-07-14
2021-12-17,Southwest,371,149,222,126,23,14,7,7,1,6,Greater MN,2022-07-14
2021-12-17,State,8267,6813,1454,5694,1119,1399,1187,212,821,366,State,2022-07-14
2021-12-17,West Central,211,98,113,85,13,17,8,9,4,4,Greater MN,2022-07-14
2020-12-18,Central,825,593,232,512,81,101,79,22,49,30,Greater MN,2022-07-14
2020-12-18,Metro,3879,3442,437,2937,505,847,711,136,540,171,Metro,2022-07-14
2020-12-18,Northeast,950,559,391,478,81,114,82,32,53,29,Greater MN,2022-07-14
2020-12-18,Northwest,325,170,155,142,28,29,11,18,7,4,Greater MN,2022-07-14
2020-12-18,South Central,415,216,199,175,41,26,12,14,4,8,Greater MN,2022-07-14
2020-12-18,Southeast,1360,899,461,845,54,268,163,105,145,18,Greater MN,2022-07-14
2020-12-18,Southwest,373,141,232,105,36,13,4,9,3,1,Greater MN,2022-07-14
2020-12-18,State,8332,6106,2226,5268,838,1418,1066,352,805,261,State,2022-07-14
2020-12-18,West Central,205,86,119,74,12,20,4,16,4,0,Greater MN,2022-07-14
2021-12-18,Central,760,629,131,478,151,116,109,7,50,59,Greater MN,2022-07-14
2021-12-18,Metro,4013,3815,198,3130,685,815,732,83,530,202,Metro,2022-07-14
2021-12-18,Northeast,921,521,400,434,87,121,92,29,63,29,Greater MN,2022-07-14
2021-12-18,Northwest,295,177,118,146,31,30,21,9,8,13,Greater MN,2022-07-14
2021-12-18,South Central,361,237,124,182,55,22,11,11,7,4,Greater MN,2022-07-14
2021-12-18,Southeast,1324,1082,242,1007,75,256,207,49,161,46,Greater MN,2022-07-14
2021-12-18,Southwest,367,142,225,125,17,14,9,5,3,6,Greater MN,2022-07-14
2021-12-18,State,8252,6691,1561,5578,1113,1391,1189,202,825,364,State,2022-07-14
2021-12-18,West Central,211,88,123,76,12,17,8,9,3,5,Greater MN,2022-07-14
2020-12-19,Central,787,563,224,482,81,108,83,25,59,24,Greater MN,2022-07-14
2020-12-19,Metro,3852,3387,465,2896,491,854,715,139,547,168,Metro,2022-07-14
2020-12-19,Northeast,955,523,432,433,90,112,86,26,65,21,Greater MN,2022-07-14
2020-12-19,Northwest,325,161,164,140,21,29,8,21,3,5,Greater MN,2022-07-14
2020-12-19,South Central,416,208,208,173,35,26,13,13,5,8,Greater MN,2022-07-14
2020-12-19,Southeast,1362,885,477,828,57,271,148,123,134,14,Greater MN,2022-07-14
2020-12-19,Southwest,371,135,236,104,31,13,2,11,1,1,Greater MN,2022-07-14
2020-12-19,State,8273,5949,2324,5134,815,1433,1060,373,819,241,State,2022-07-14
2020-12-19,West Central,205,87,118,78,9,20,5,15,5,0,Greater MN,2022-07-14
2021-12-19,Central,740,602,138,451,151,115,111,4,51,60,Greater MN,2022-07-14
2021-12-19,Metro,3866,3618,248,2947,671,823,731,92,527,204,Metro,2022-07-14
2021-12-19,Northeast,920,499,421,406,93,121,87,34,62,25,Greater MN,2022-07-14
2021-12-19,Northwest,295,180,115,152,28,30,20,10,7,13,Greater MN,2022-07-14
2021-12-19,South Central,360,236,124,173,63,22,10,12,6,4,Greater MN,2022-07-14
2021-12-19,Southeast,1326,1033,293,955,78,255,184,71,137,47,Greater MN,2022-07-14
2021-12-19,Southwest,367,145,222,127,18,13,7,6,3,4,Greater MN,2022-07-14
2021-12-19,State,8085,6384,1701,5271,1113,1396,1159,237,798,361,State,2022-07-14
2021-12-19,West Central,211,71,140,60,11,17,9,8,5,4,Greater MN,2022-07-14
2020-12-20,Central,766,530,236,449,81,111,80,31,53,27,Greater MN,2022-07-14
2020-12-20,Metro,3779,3262,517,2789,473,838,681,157,522,159,Metro,2022-07-14
2020-12-20,Northeast,954,523,431,430,93,117,84,33,61,23,Greater MN,2022-07-14
2020-12-20,Northwest,325,157,168,132,25,29,11,18,5,6,Greater MN,2022-07-14
2020-12-20,South Central,413,195,218,151,44,26,12,14,6,6,Greater MN,2022-07-14
2020-12-20,Southeast,1356,817,539,760,57,271,135,136,118,17,Greater MN,2022-07-14
2020-12-20,Southwest,361,116,245,88,28,14,3,11,2,1,Greater MN,2022-07-14
2020-12-20,State,8159,5672,2487,4861,811,1426,1015,411,776,239,State,2022-07-14
2020-12-20,West Central,205,72,133,62,10,20,9,11,9,0,Greater MN,2022-07-14
2021-12-20,Central,742,639,103,482,157,120,113,7,58,55,Greater MN,2022-07-14
2021-12-20,Metro,3832,3552,280,2894,658,817,722,95,522,200,Metro,2022-07-14
2021-12-20,Northeast,922,522,400,424,98,108,81,27,56,25,Greater MN,2022-07-14
2021-12-20,Northwest,295,173,122,145,28,30,20,10,10,10,Greater MN,2022-07-14
2021-12-20,South Central,362,227,135,161,66,22,11,11,7,4,Greater MN,2022-07-14
2021-12-20,Southeast,1314,1009,305,929,80,256,183,73,133,50,Greater MN,2022-07-14
2021-12-20,Southwest,375,149,226,133,16,14,10,4,3,7,Greater MN,2022-07-14
2021-12-20,State,8053,6363,1690,5247,1116,1384,1147,237,792,355,State,2022-07-14
2021-12-20,West Central,211,92,119,79,13,17,7,10,3,4,Greater MN,2022-07-14
2020-12-21,Central,770,535,235,447,88,104,75,29,51,24,Greater MN,2022-07-14
2020-12-21,Metro,3723,3211,512,2735,476,820,680,140,526,154,Metro,2022-07-14
2020-12-21,Northeast,958,537,421,444,93,112,84,28,60,24,Greater MN,2022-07-14
2020-12-21,Northwest,325,165,160,136,29,29,8,21,3,5,Greater MN,2022-07-14
2020-12-21,South Central,414,198,216,158,40,27,12,15,8,4,Greater MN,2022-07-14
2020-12-21,Southeast,1352,778,574,716,62,272,139,133,123,16,Greater MN,2022-07-14
2020-12-21,Southwest,362,113,249,82,31,14,4,10,3,1,Greater MN,2022-07-14
2020-12-21,State,8109,5626,2483,4794,832,1398,1010,388,782,228,State,2022-07-14
2020-12-21,West Central,205,89,116,76,13,20,8,12,8,0,Greater MN,2022-07-14
2021-12-21,Central,761,656,105,497,159,120,117,3,63,54,Greater MN,2022-07-14
2021-12-21,Metro,3987,3720,267,3089,631,849,771,78,567,204,Metro,2022-07-14
2021-12-21,Northeast,912,519,393,424,95,106,77,29,56,21,Greater MN,2022-07-14
2021-12-21,Northwest,294,183,111,158,25,31,22,9,11,11,Greater MN,2022-07-14
2021-12-21,South Central,367,237,130,174,63,22,12,10,7,5,Greater MN,2022-07-14
2021-12-21,Southeast,1313,1052,261,970,82,256,184,72,142,42,Greater MN,2022-07-14
2021-12-21,Southwest,371,145,226,127,18,13,10,3,3,7,Greater MN,2022-07-14
2021-12-21,State,8216,6605,1611,5520,1085,1414,1200,214,853,347,State,2022-07-14
2021-12-21,West Central,211,93,118,81,12,17,7,10,4,3,Greater MN,2022-07-14
2020-12-22,Central,813,566,247,490,76,106,79,27,55,24,Greater MN,2022-07-14
2020-12-22,Metro,3826,3390,436,2885,505,832,681,151,516,165,Metro,2022-07-14
2020-12-22,Northeast,969,554,415,460,94,112,83,29,58,25,Greater MN,2022-07-14
2020-12-22,Northwest,321,174,147,146,28,28,7,21,4,3,Greater MN,2022-07-14
2020-12-22,South Central,418,197,221,161,36,27,13,14,9,4,Greater MN,2022-07-14
2020-12-22,Southeast,1346,838,508,778,60,271,152,119,136,16,Greater MN,2022-07-14
2020-12-22,Southwest,376,136,240,103,33,14,4,10,3,1,Greater MN,2022-07-14
2020-12-22,State,8274,5950,2324,5112,838,1410,1025,385,787,238,State,2022-07-14
2020-12-22,West Central,205,95,110,89,6,20,6,14,6,0,Greater MN,2022-07-14
2021-12-22,Central,788,682,106,521,161,114,110,4,55,55,Greater MN,2022-07-14
2021-12-22,Metro,4142,3917,225,3283,634,817,736,81,536,200,Metro,2022-07-14
2021-12-22,Northeast,848,527,321,438,89,110,83,27,60,23,Greater MN,2022-07-14
2021-12-22,Northwest,295,194,101,170,24,30,21,9,10,11,Greater MN,2022-07-14
2021-12-22,South Central,355,248,107,184,64,24,13,11,9,4,Greater MN,2022-07-14
2021-12-22,Southeast,1327,1121,206,1043,78,255,194,61,153,41,Greater MN,2022-07-14
2021-12-22,Southwest,385,146,239,130,16,14,8,6,2,6,Greater MN,2022-07-14
2021-12-22,State,8347,6969,1378,5887,1082,1381,1173,208,831,342,State,2022-07-14
2021-12-22,West Central,207,134,73,118,16,17,8,9,6,2,Greater MN,2022-07-14
2020-12-23,Central,835,608,227,532,76,111,84,27,64,20,Greater MN,2022-07-14
2020-12-23,Metro,4009,3525,484,3015,510,848,687,161,525,162,Metro,2022-07-14
2020-12-23,Northeast,960,559,401,473,86,112,77,35,52,25,Greater MN,2022-07-14
2020-12-23,Northwest,339,197,142,176,21,27,8,19,5,3,Greater MN,2022-07-14
2020-12-23,South Central,415,209,206,178,31,25,11,14,5,6,Greater MN,2022-07-14
2020-12-23,Southeast,1367,864,503,811,53,269,144,125,124,20,Greater MN,2022-07-14
2020-12-23,Southwest,394,139,255,111,28,13,1,12,1,0,Greater MN,2022-07-14
2020-12-23,State,8556,6217,2339,5407,810,1425,1021,404,783,238,State,2022-07-14
2020-12-23,West Central,237,116,121,111,5,20,9,11,7,2,Greater MN,2022-07-14
2021-12-23,Central,707,597,110,438,159,116,107,9,53,54,Greater MN,2022-07-14
2021-12-23,Metro,3906,3706,200,3068,638,830,745,85,549,196,Metro,2022-07-14
2021-12-23,Northeast,775,518,257,429,89,110,82,28,59,23,Greater MN,2022-07-14
2021-12-23,Northwest,277,165,112,149,16,30,23,7,13,10,Greater MN,2022-07-14
2021-12-23,South Central,354,226,128,164,62,23,11,12,7,4,Greater MN,2022-07-14
2021-12-23,Southeast,1303,1084,219,1016,68,252,189,63,151,38,Greater MN,2022-07-14
2021-12-23,Southwest,364,120,244,102,18,13,8,5,2,6,Greater MN,2022-07-14
2021-12-23,State,7860,6511,1349,5450,1061,1391,1174,217,839,335,State,2022-07-14
2021-12-23,West Central,174,95,79,84,11,17,9,8,5,4,Greater MN,2022-07-14
2020-12-24,Central,760,543,217,472,71,105,74,31,56,18,Greater MN,2022-07-14
2020-12-24,Metro,3751,3238,513,2778,460,847,694,153,534,160,Metro,2022-07-14
2020-12-24,Northeast,959,525,434,432,93,112,82,30,66,16,Greater MN,2022-07-14
2020-12-24,Northwest,326,189,137,167,22,29,10,19,6,4,Greater MN,2022-07-14
2020-12-24,South Central,412,188,224,156,32,25,11,14,4,7,Greater MN,2022-07-14
2020-12-24,Southeast,1356,813,543,760,53,268,158,110,135,23,Greater MN,2022-07-14
2020-12-24,Southwest,358,120,238,99,21,16,3,13,3,0,Greater MN,2022-07-14
2020-12-24,State,8127,5699,2428,4941,758,1422,1040,382,810,230,State,2022-07-14
2020-12-24,West Central,205,83,122,77,6,20,8,12,6,2,Greater MN,2022-07-14
2021-12-24,Central,743,620,123,468,152,117,107,10,52,55,Greater MN,2022-07-14
2021-12-24,Metro,3828,3655,173,3010,645,822,729,93,534,195,Metro,2022-07-14
2021-12-24,Northeast,769,483,286,399,84,107,78,29,52,26,Greater MN,2022-07-14
2021-12-24,Northwest,275,153,122,139,14,27,18,9,9,9,Greater MN,2022-07-14
2021-12-24,South Central,348,206,142,158,48,22,12,10,8,4,Greater MN,2022-07-14
2021-12-24,Southeast,1301,1051,250,978,73,253,191,62,152,39,Greater MN,2022-07-14
2021-12-24,Southwest,365,122,243,100,22,13,8,5,3,5,Greater MN,2022-07-14
2021-12-24,State,7803,6378,1425,5326,1052,1378,1152,226,815,337,State,2022-07-14
2021-12-24,West Central,174,88,86,74,14,17,9,8,5,4,Greater MN,2022-07-14
2020-12-25,Central,704,439,265,377,62,107,74,33,55,19,Greater MN,2022-07-14
2020-12-25,Metro,3590,2822,768,2428,394,850,691,159,534,157,Metro,2022-07-14
2020-12-25,Northeast,959,472,487,381,91,112,66,46,53,13,Greater MN,2022-07-14
2020-12-25,Northwest,323,158,165,132,26,29,13,16,8,5,Greater MN,2022-07-14
2020-12-25,South Central,412,149,263,121,28,25,10,15,5,5,Greater MN,2022-07-14
2020-12-25,Southeast,1348,724,624,664,60,268,147,121,126,21,Greater MN,2022-07-14
2020-12-25,Southwest,359,105,254,83,22,14,5,9,5,0,Greater MN,2022-07-14
2020-12-25,State,7900,4936,2964,4246,690,1425,1011,414,790,221,State,2022-07-14
2020-12-25,West Central,205,67,138,60,7,20,5,15,4,1,Greater MN,2022-07-14
2021-12-25,Central,721,580,141,432,148,117,109,8,54,55,Greater MN,2022-07-14
2021-12-25,Metro,3660,3278,382,2674,604,827,740,87,544,196,Metro,2022-07-14
2021-12-25,Northeast,806,449,357,373,76,109,79,30,54,25,Greater MN,2022-07-14
2021-12-25,Northwest,272,136,136,123,13,26,16,10,9,7,Greater MN,2022-07-14
2021-12-25,South Central,347,205,142,158,47,22,12,10,8,4,Greater MN,2022-07-14
2021-12-25,Southeast,1297,904,393,844,60,253,170,83,130,40,Greater MN,2022-07-14
2021-12-25,Southwest,365,121,244,94,27,13,9,4,4,5,Greater MN,2022-07-14
2021-12-25,State,7642,5754,1888,4767,987,1384,1144,240,807,337,State,2022-07-14
2021-12-25,West Central,174,81,93,69,12,17,9,8,4,5,Greater MN,2022-07-14
2020-12-26,Central,761,491,270,426,65,103,72,31,51,21,Greater MN,2022-07-14
2020-12-26,Metro,3532,2811,721,2402,409,842,677,165,526,151,Metro,2022-07-14
2020-12-26,Northeast,957,465,492,378,87,112,73,39,57,16,Greater MN,2022-07-14
2020-12-26,Northwest,323,148,175,120,28,29,12,17,8,4,Greater MN,2022-07-14
2020-12-26,South Central,408,154,254,126,28,25,10,15,6,4,Greater MN,2022-07-14
2020-12-26,Southeast,1332,677,655,620,57,266,143,123,121,22,Greater MN,2022-07-14
2020-12-26,Southwest,357,97,260,73,24,13,2,11,1,1,Greater MN,2022-07-14
2020-12-26,State,7875,4899,2976,4190,709,1410,996,414,776,220,State,2022-07-14
2020-12-26,West Central,205,56,149,45,11,20,7,13,6,1,Greater MN,2022-07-14
2021-12-26,Central,687,543,144,398,145,113,102,11,45,57,Greater MN,2022-07-14
2021-12-26,Metro,3690,3411,279,2787,624,825,735,90,537,198,Metro,2022-07-14
2021-12-26,Northeast,793,476,317,396,80,108,79,29,52,27,Greater MN,2022-07-14
2021-12-26,Northwest,272,142,130,127,15,26,14,12,9,5,Greater MN,2022-07-14
2021-12-26,South Central,346,207,139,161,46,22,12,10,7,5,Greater MN,2022-07-14
2021-12-26,Southeast,1304,868,436,809,59,253,171,82,132,39,Greater MN,2022-07-14
2021-12-26,Southwest,360,118,242,91,27,13,9,4,4,5,Greater MN,2022-07-14
2021-12-26,State,7626,5861,1765,4850,1011,1377,1129,248,790,339,State,2022-07-14
2021-12-26,West Central,174,96,78,81,15,17,7,10,4,3,Greater MN,2022-07-14
2020-12-27,Central,793,498,295,422,76,97,70,27,49,21,Greater MN,2022-07-14
2020-12-27,Metro,3599,2927,672,2503,424,844,681,163,540,141,Metro,2022-07-14
2020-12-27,Northeast,966,503,463,415,88,112,73,39,54,19,Greater MN,2022-07-14
2020-12-27,Northwest,323,152,171,127,25,29,13,16,9,4,Greater MN,2022-07-14
2020-12-27,South Central,406,174,232,148,26,26,11,15,6,5,Greater MN,2022-07-14
2020-12-27,Southeast,1333,706,627,648,58,269,139,130,120,19,Greater MN,2022-07-14
2020-12-27,Southwest,365,116,249,91,25,13,2,11,1,1,Greater MN,2022-07-14
2020-12-27,State,7990,5144,2846,4411,733,1410,997,413,785,212,State,2022-07-14
2020-12-27,West Central,205,68,137,57,11,20,8,12,6,2,Greater MN,2022-07-14
2021-12-27,Central,723,596,127,444,152,117,108,9,51,57,Greater MN,2022-07-14
2021-12-27,Metro,3688,3541,147,2899,642,823,731,92,537,194,Metro,2022-07-14
2021-12-27,Northeast,793,506,287,434,72,107,82,25,53,29,Greater MN,2022-07-14
2021-12-27,Northwest,276,155,121,139,16,25,12,13,7,5,Greater MN,2022-07-14
2021-12-27,South Central,349,211,138,166,45,22,12,10,7,5,Greater MN,2022-07-14
2021-12-27,Southeast,1294,895,399,832,63,252,160,92,124,36,Greater MN,2022-07-14
2021-12-27,Southwest,359,130,229,104,26,15,10,5,3,7,Greater MN,2022-07-14
2021-12-27,State,7656,6134,1522,5100,1034,1378,1122,256,787,335,State,2022-07-14
2021-12-27,West Central,174,100,74,82,18,17,7,10,5,2,Greater MN,2022-07-14
2020-12-28,Central,790,536,254,463,73,96,66,30,43,23,Greater MN,2022-07-14
2020-12-28,Metro,3603,3030,573,2597,433,835,688,147,544,144,Metro,2022-07-14
2020-12-28,Northeast,967,533,434,441,92,112,82,30,63,19,Greater MN,2022-07-14
2020-12-28,Northwest,321,166,155,140,26,27,13,14,9,4,Greater MN,2022-07-14
2020-12-28,South Central,408,204,204,178,26,25,11,14,8,3,Greater MN,2022-07-14
2020-12-28,Southeast,1348,740,608,676,64,266,128,138,112,16,Greater MN,2022-07-14
2020-12-28,Southwest,370,123,247,95,28,15,2,13,1,1,Greater MN,2022-07-14
2020-12-28,State,8012,5410,2602,4658,752,1396,999,397,786,213,State,2022-07-14
2020-12-28,West Central,205,78,127,68,10,20,9,11,6,3,Greater MN,2022-07-14
2021-12-28,Central,738,619,119,463,156,115,108,7,56,52,Greater MN,2022-07-14
2021-12-28,Metro,3907,3742,165,3115,627,827,747,80,558,189,Metro,2022-07-14
2021-12-28,Northeast,779,559,220,487,72,112,77,35,49,28,Greater MN,2022-07-14
2021-12-28,Northwest,275,166,109,152,14,28,17,11,10,7,Greater MN,2022-07-14
2021-12-28,South Central,349,233,116,179,54,23,11,12,5,6,Greater MN,2022-07-14
2021-12-28,Southeast,1317,992,325,934,58,253,182,71,143,39,Greater MN,2022-07-14
2021-12-28,Southwest,362,148,214,128,20,15,9,6,2,7,Greater MN,2022-07-14
2021-12-28,State,7905,6581,1324,5561,1020,1386,1155,231,825,330,State,2022-07-14
2021-12-28,West Central,178,122,56,103,19,13,4,9,2,2,Greater MN,2022-07-14
2020-12-29,Central,813,608,205,547,61,97,70,27,51,19,Greater MN,2022-07-14
2020-12-29,Metro,3773,3348,425,2918,430,849,708,141,566,142,Metro,2022-07-14
2020-12-29,Northeast,967,547,420,462,85,112,78,34,59,19,Greater MN,2022-07-14
2020-12-29,Northwest,322,168,154,146,22,27,12,15,10,2,Greater MN,2022-07-14
2020-12-29,South Central,413,212,201,185,27,26,12,14,8,4,Greater MN,2022-07-14
2020-12-29,Southeast,1341,811,530,748,63,271,151,120,134,17,Greater MN,2022-07-14
2020-12-29,Southwest,373,146,227,120,26,16,5,11,4,1,Greater MN,2022-07-14
2020-12-29,State,8207,5925,2282,5205,720,1418,1044,374,837,207,State,2022-07-14
2020-12-29,West Central,205,85,120,79,6,20,8,12,5,3,Greater MN,2022-07-14
2021-12-29,Central,774,673,101,532,141,118,109,9,59,50,Greater MN,2022-07-14
2021-12-29,Metro,4187,4019,168,3372,647,833,750,83,574,176,Metro,2022-07-14
2021-12-29,Northeast,798,550,248,486,64,111,77,34,50,27,Greater MN,2022-07-14
2021-12-29,Northwest,293,171,122,158,13,30,18,12,12,6,Greater MN,2022-07-14
2021-12-29,South Central,353,238,115,190,48,24,14,10,8,6,Greater MN,2022-07-14
2021-12-29,Southeast,1333,1041,292,981,60,252,178,74,142,36,Greater MN,2022-07-14
2021-12-29,Southwest,383,162,221,141,21,14,7,7,2,5,Greater MN,2022-07-14
2021-12-29,State,8329,6997,1332,5985,1012,1397,1156,241,848,308,State,2022-07-14
2021-12-29,West Central,208,143,65,125,18,15,3,12,1,2,Greater MN,2022-07-14
2020-12-30,Central,885,651,234,588,63,105,73,32,53,20,Greater MN,2022-07-14
2020-12-30,Metro,4030,3600,430,3186,414,847,703,144,572,131,Metro,2022-07-14
2020-12-30,Northeast,967,542,425,451,91,114,80,34,64,16,Greater MN,2022-07-14
2020-12-30,Northwest,339,202,137,180,22,29,13,16,9,4,Greater MN,2022-07-14
2020-12-30,South Central,418,213,205,186,27,24,12,12,7,5,Greater MN,2022-07-14
2020-12-30,Southeast,1367,892,475,840,52,271,145,126,126,19,Greater MN,2022-07-14
2020-12-30,Southwest,385,161,224,136,25,17,6,11,6,0,Greater MN,2022-07-14
2020-12-30,State,8628,6377,2251,5673,704,1427,1038,389,841,197,State,2022-07-14
2020-12-30,West Central,237,116,121,106,10,20,6,14,4,2,Greater MN,2022-07-14
2021-12-30,Central,730,627,103,482,145,116,106,10,57,49,Greater MN,2022-07-14
2021-12-30,Metro,3989,3870,119,3210,660,836,748,88,584,164,Metro,2022-07-14
2021-12-30,Northeast,783,535,248,470,65,111,79,32,56,23,Greater MN,2022-07-14
2021-12-30,Northwest,274,160,114,148,12,30,17,13,11,6,Greater MN,2022-07-14
2021-12-30,South Central,353,229,124,185,44,22,9,13,3,6,Greater MN,2022-07-14
2021-12-30,Southeast,1319,1086,233,1019,67,256,173,83,141,32,Greater MN,2022-07-14
2021-12-30,Southwest,364,170,194,149,21,14,7,7,3,4,Greater MN,2022-07-14
2021-12-30,State,7988,6787,1201,5754,1033,1400,1142,258,857,285,State,2022-07-14
2021-12-30,West Central,176,110,66,91,19,15,3,12,2,1,Greater MN,2022-07-14
2020-12-31,Central,801,595,206,530,65,98,70,28,49,21,Greater MN,2022-07-14
2020-12-31,Metro,3821,3395,426,3012,383,857,713,144,591,122,Metro,2022-07-14
2020-12-31,Northeast,967,540,427,457,83,114,82,32,67,15,Greater MN,2022-07-14
2020-12-31,Northwest,322,177,145,158,19,29,7,22,4,3,Greater MN,2022-07-14
2020-12-31,South Central,416,195,221,167,28,25,11,14,7,4,Greater MN,2022-07-14
2020-12-31,Southeast,1355,889,466,835,54,268,155,113,133,22,Greater MN,2022-07-14
2020-12-31,Southwest,370,160,210,131,29,14,1,13,0,1,Greater MN,2022-07-14
2020-12-31,State,8257,6049,2208,5374,675,1425,1044,381,854,190,State,2022-07-14
2020-12-31,West Central,205,98,107,84,14,20,5,15,3,2,Greater MN,2022-07-14
2021-12-31,Central,721,601,120,466,135,112,103,9,55,48,Greater MN,2022-07-14
2021-12-31,Metro,3973,3847,126,3186,661,830,736,94,575,161,Metro,2022-07-14
2021-12-31,Northeast,771,486,285,421,65,112,86,26,59,27,Greater MN,2022-07-14
2021-12-31,Northwest,278,165,113,147,18,29,14,15,7,7,Greater MN,2022-07-14
2021-12-31,South Central,354,223,131,175,48,22,10,12,4,6,Greater MN,2022-07-14
2021-12-31,Southeast,1312,1056,256,996,60,251,187,64,149,38,Greater MN,2022-07-14
2021-12-31,Southwest,364,161,203,143,18,14,8,6,4,4,Greater MN,2022-07-14
2021-12-31,State,7949,6646,1303,5626,1020,1385,1147,238,855,292,State,2022-07-14
2021-12-31,West Central,176,107,69,92,15,15,3,12,2,1,Greater MN,2022-07-14
2020-07-01,Central,957,569,388,569,1,180,75,105,75,1,Greater MN,2022-07-14
2020-07-02,Central,955,571,384,571,1,182,84,98,84,1,Greater MN,2022-07-14
2020-07-03,Central,914,539,375,539,2,174,91,83,91,1,Greater MN,2022-07-14
2020-07-04,Central,957,486,471,486,2,180,90,90,90,1,Greater MN,2022-07-14
2020-07-05,Central,913,484,429,484,1,175,86,89,86,1,Greater MN,2022-07-14
2020-07-06,Central,951,516,435,516,1,181,79,102,79,1,Greater MN,2022-07-14
2020-07-07,Central,954,571,383,571,0,178,78,100,78,3,Greater MN,2022-07-14
2020-07-08,Central,955,604,351,604,0,172,77,95,77,3,Greater MN,2022-07-14
2020-07-09,Central,955,607,348,607,0,172,85,87,85,4,Greater MN,2022-07-14
2020-07-10,Central,885,539,346,539,0,160,76,84,76,5,Greater MN,2022-07-14
2020-07-11,Central,960,485,475,485,0,172,80,92,80,3,Greater MN,2022-07-14
2020-07-12,Central,960,491,469,491,0,172,68,104,68,3,Greater MN,2022-07-14
2020-07-13,Central,960,526,434,526,2,172,66,106,66,1,Greater MN,2022-07-14
2020-07-14,Central,965,524,441,524,3,172,66,106,66,0,Greater MN,2022-07-14
2020-07-15,Central,965,604,361,604,3,172,72,100,72,1,Greater MN,2022-07-14
2020-07-16,Central,1040,554,486,554,3,72,82,-10,82,1,Greater MN,2022-07-14
2020-07-17,Central,969,522,447,522,0,171,50,121,50,4,Greater MN,2022-07-14
2020-07-18,Central,964,532,432,532,0,171,52,119,52,4,Greater MN,2022-07-14
2020-07-19,Central,964,546,418,546,1,171,44,127,44,3,Greater MN,2022-07-14
2020-07-20,Central,969,514,455,514,2,171,45,126,45,3,Greater MN,2022-07-14
2020-07-21,Central,969,577,392,577,0,171,50,121,50,4,Greater MN,2022-07-14
2020-07-22,Central,964,599,365,599,0,171,51,120,51,4,Greater MN,2022-07-14
2020-07-23,Central,964,567,397,567,0,171,45,126,45,4,Greater MN,2022-07-14
2020-07-24,Central,979,553,426,543,11,169,88,81,85,3,Greater MN,2022-07-14
2020-07-25,Central,956,487,469,479,10,163,93,70,90,3,Greater MN,2022-07-14
2020-07-26,Central,897,475,422,466,10,163,92,71,87,5,Greater MN,2022-07-14
2020-07-27,Central,877,473,404,463,10,163,97,66,91,7,Greater MN,2022-07-14
2020-07-28,Central,909,584,325,574,11,165,89,76,85,4,Greater MN,2022-07-14
2020-07-29,Central,904,536,368,525,11,165,96,69,92,5,Greater MN,2022-07-14
2020-07-30,Central,878,560,318,549,10,162,101,61,97,5,Greater MN,2022-07-14
2020-07-31,Central,909,565,344,553,11,164,103,61,98,5,Greater MN,2022-07-14
2020-07-01,Metro,5319,3821,1498,3821,125,1013,724,289,724,71,Metro,2022-07-14
2020-07-02,Metro,5322,3771,1551,3771,136,989,694,295,694,62,Metro,2022-07-14
2020-07-03,Metro,5302,3611,1691,3611,128,995,713,282,713,69,Metro,2022-07-14
2020-07-04,Metro,5287,3315,1972,3315,124,967,675,292,675,67,Metro,2022-07-14
2020-07-05,Metro,5245,3243,2002,3243,134,980,660,320,660,59,Metro,2022-07-14
2020-07-06,Metro,5297,3465,1832,3465,146,985,664,321,664,53,Metro,2022-07-14
2020-07-07,Metro,5320,3783,1537,3783,135,1001,694,307,694,63,Metro,2022-07-14
2020-07-08,Metro,5369,3901,1468,3901,121,978,682,296,682,61,Metro,2022-07-14
2020-07-09,Metro,5321,3963,1358,3963,113,968,696,272,696,57,Metro,2022-07-14
2020-07-10,Metro,5107,3721,1386,3721,115,912,637,275,637,51,Metro,2022-07-14
2020-07-11,Metro,4984,3420,1564,3420,114,861,594,267,594,49,Metro,2022-07-14
2020-07-12,Metro,4980,3305,1675,3305,119,862,546,316,546,48,Metro,2022-07-14
2020-07-13,Metro,5346,3636,1710,3636,122,958,671,287,671,50,Metro,2022-07-14
2020-07-14,Metro,5340,3836,1504,3836,129,978,705,273,705,51,Metro,2022-07-14
2020-07-15,Metro,5357,3909,1448,3909,134,977,698,279,698,50,Metro,2022-07-14
2020-07-16,Metro,5388,3935,1453,3935,123,1067,732,335,732,54,Metro,2022-07-14
2020-07-17,Metro,5342,3853,1489,3853,128,939,723,216,723,58,Metro,2022-07-14
2020-07-18,Metro,5446,3606,1840,3606,121,977,727,250,727,61,Metro,2022-07-14
2020-07-19,Metro,5000,3200,1800,3200,93,873,628,245,628,95,Metro,2022-07-14
2020-07-20,Metro,5392,3718,1674,3718,134,962,699,263,699,67,Metro,2022-07-14
2020-07-21,Metro,5357,3897,1460,3897,142,962,741,221,741,67,Metro,2022-07-14
2020-07-22,Metro,5387,3971,1416,3971,148,1095,735,360,735,69,Metro,2022-07-14
2020-07-23,Metro,5327,3921,1406,3920,148,1053,711,342,711,69,Metro,2022-07-14
2020-07-24,Metro,4932,3920,1012,3836,149,893,725,168,685,64,Metro,2022-07-14
2020-07-25,Metro,4709,3579,1130,3505,137,823,686,137,646,62,Metro,2022-07-14
2020-07-26,Metro,4256,3578,678,3480,174,842,701,141,683,43,Metro,2022-07-14
2020-07-27,Metro,4201,3456,745,3371,145,793,636,157,595,58,Metro,2022-07-14
2020-07-28,Metro,4251,3595,656,3509,142,831,650,181,602,67,Metro,2022-07-14
2020-07-29,Metro,4378,3719,659,3645,125,848,659,189,604,73,Metro,2022-07-14
2020-07-30,Metro,4859,3966,893,3889,147,918,760,158,709,79,Metro,2022-07-14
2020-07-31,Metro,4774,3952,822,3870,166,913,737,176,684,82,Metro,2022-07-14
2020-07-01,Northeast,1191,543,648,543,2,114,82,32,82,0,Greater MN,2022-07-14
2020-07-02,Northeast,1168,546,622,546,2,112,79,33,79,0,Greater MN,2022-07-14
2020-07-03,Northeast,1191,512,679,512,2,114,76,38,76,0,Greater MN,2022-07-14
2020-07-04,Northeast,1263,518,745,518,2,116,79,37,79,0,Greater MN,2022-07-14
2020-07-05,Northeast,1168,502,666,502,3,112,76,36,76,0,Greater MN,2022-07-14
2020-07-06,Northeast,1191,554,637,554,2,114,76,38,76,1,Greater MN,2022-07-14
2020-07-07,Northeast,1191,552,639,552,3,114,75,39,75,1,Greater MN,2022-07-14
2020-07-08,Northeast,1191,558,633,558,3,114,82,32,82,1,Greater MN,2022-07-14
2020-07-09,Northeast,1191,566,625,566,3,114,74,40,74,2,Greater MN,2022-07-14
2020-07-10,Northeast,1231,598,633,598,3,116,75,41,75,2,Greater MN,2022-07-14
2020-07-11,Northeast,1191,547,644,547,3,114,78,36,78,3,Greater MN,2022-07-14
2020-07-12,Northeast,1191,524,667,524,5,114,68,46,68,2,Greater MN,2022-07-14
2020-07-13,Northeast,1191,537,654,537,6,114,68,46,68,4,Greater MN,2022-07-14
2020-07-14,Northeast,1263,580,683,580,14,116,75,41,75,2,Greater MN,2022-07-14
2020-07-15,Northeast,1263,601,662,601,10,116,75,41,75,1,Greater MN,2022-07-14
2020-07-16,Northeast,1215,589,626,589,12,116,75,41,75,0,Greater MN,2022-07-14
2020-07-17,Northeast,1189,532,657,532,9,114,72,42,72,0,Greater MN,2022-07-14
2020-07-18,Northeast,1261,527,734,527,10,116,66,50,66,0,Greater MN,2022-07-14
2020-07-19,Northeast,1261,524,737,524,10,116,64,52,64,1,Greater MN,2022-07-14
2020-07-20,Northeast,1229,555,674,555,8,116,72,44,72,0,Greater MN,2022-07-14
2020-07-21,Northeast,1189,595,594,595,7,114,80,34,80,0,Greater MN,2022-07-14
2020-07-22,Northeast,1189,607,582,607,7,114,67,47,67,0,Greater MN,2022-07-14
2020-07-23,Northeast,1177,581,596,575,6,114,67,47,67,0,Greater MN,2022-07-14
2020-07-24,Northeast,785,384,401,378,6,91,55,36,55,0,Greater MN,2022-07-14
2020-07-25,Northeast,749,392,357,387,5,87,48,39,48,0,Greater MN,2022-07-14
2020-07-26,Northeast,495,368,127,362,6,87,42,45,42,0,Greater MN,2022-07-14
2020-07-27,Northeast,1149,568,581,561,7,116,59,57,59,0,Greater MN,2022-07-14
2020-07-28,Northeast,1173,601,572,591,10,116,81,35,81,0,Greater MN,2022-07-14
2020-07-29,Northeast,1089,598,491,586,12,115,74,41,73,1,Greater MN,2022-07-14
2020-07-30,Northeast,1125,583,542,571,12,113,78,35,78,0,Greater MN,2022-07-14
2020-07-31,Northeast,1156,602,554,591,11,113,79,34,79,0,Greater MN,2022-07-14
2020-07-01,Northwest,348,154,194,154,0,32,11,21,11,0,Greater MN,2022-07-14
2020-07-02,Northwest,348,143,205,143,0,32,10,22,10,0,Greater MN,2022-07-14
2020-07-03,Northwest,348,144,204,144,0,32,12,20,12,0,Greater MN,2022-07-14
2020-07-04,Northwest,336,120,216,120,0,32,10,22,10,0,Greater MN,2022-07-14
2020-07-05,Northwest,311,118,193,118,1,27,5,22,5,0,Greater MN,2022-07-14
2020-07-06,Northwest,348,117,231,117,0,32,13,19,13,0,Greater MN,2022-07-14
2020-07-07,Northwest,348,144,204,144,0,32,8,24,8,0,Greater MN,2022-07-14
2020-07-08,Northwest,333,146,187,146,0,32,9,23,9,0,Greater MN,2022-07-14
2020-07-09,Northwest,333,154,179,154,0,32,9,23,9,0,Greater MN,2022-07-14
2020-07-10,Northwest,333,140,193,140,0,32,13,19,13,0,Greater MN,2022-07-14
2020-07-11,Northwest,321,128,193,128,0,32,14,18,14,0,Greater MN,2022-07-14
2020-07-12,Northwest,321,138,183,138,0,32,12,20,12,0,Greater MN,2022-07-14
2020-07-13,Northwest,333,117,216,117,1,32,14,18,14,0,Greater MN,2022-07-14
2020-07-14,Northwest,333,110,223,110,1,32,12,20,12,0,Greater MN,2022-07-14
2020-07-15,Northwest,333,127,206,127,3,32,15,17,15,0,Greater MN,2022-07-14
2020-07-16,Northwest,333,145,188,145,2,32,14,18,14,0,Greater MN,2022-07-14
2020-07-17,Northwest,332,157,175,157,7,32,15,17,15,0,Greater MN,2022-07-14
2020-07-18,Northwest,320,130,190,130,2,32,11,21,11,0,Greater MN,2022-07-14
2020-07-19,Northwest,320,132,188,132,1,32,8,24,8,0,Greater MN,2022-07-14
2020-07-20,Northwest,331,125,206,125,2,33,11,22,11,0,Greater MN,2022-07-14
2020-07-21,Northwest,332,131,201,131,0,32,10,22,10,1,Greater MN,2022-07-14
2020-07-22,Northwest,324,148,176,148,2,32,13,19,13,1,Greater MN,2022-07-14
2020-07-23,Northwest,299,126,173,126,0,27,10,17,10,0,Greater MN,2022-07-14
2020-07-24,Northwest,292,130,162,130,2,27,15,12,15,2,Greater MN,2022-07-14
2020-07-25,Northwest,315,135,180,135,2,27,7,20,7,3,Greater MN,2022-07-14
2020-07-26,Northwest,309,118,191,117,2,37,18,19,18,3,Greater MN,2022-07-14
2020-07-27,Northwest,315,115,200,114,2,27,7,20,7,2,Greater MN,2022-07-14
2020-07-28,Northwest,314,129,185,128,4,20,8,12,8,0,Greater MN,2022-07-14
2020-07-29,Northwest,331,117,214,116,3,20,10,10,10,1,Greater MN,2022-07-14
2020-07-30,Northwest,324,129,195,127,4,27,8,19,8,0,Greater MN,2022-07-14
2020-07-31,Northwest,343,135,208,132,3,25,11,14,11,0,Greater MN,2022-07-14
2020-07-01,South Central,562,207,355,207,7,32,12,20,12,3,Greater MN,2022-07-14
2020-07-02,South Central,561,200,361,200,9,32,12,20,12,3,Greater MN,2022-07-14
2020-07-03,South Central,561,197,364,197,8,32,9,23,9,3,Greater MN,2022-07-14
2020-07-04,South Central,542,160,382,160,5,32,9,23,9,3,Greater MN,2022-07-14
2020-07-05,South Central,567,178,389,178,7,32,7,25,7,3,Greater MN,2022-07-14
2020-07-06,South Central,567,194,373,194,6,32,9,23,9,3,Greater MN,2022-07-14
2020-07-07,South Central,567,203,364,203,10,32,11,21,11,2,Greater MN,2022-07-14
2020-07-08,South Central,571,217,354,217,10,28,11,17,11,2,Greater MN,2022-07-14
2020-07-09,South Central,571,231,340,231,7,28,6,22,6,2,Greater MN,2022-07-14
2020-07-10,South Central,571,215,356,215,7,28,10,18,10,2,Greater MN,2022-07-14
2020-07-11,South Central,546,186,360,186,7,28,7,21,7,1,Greater MN,2022-07-14
2020-07-12,South Central,571,205,366,205,5,28,9,19,9,1,Greater MN,2022-07-14
2020-07-13,South Central,571,221,350,221,7,28,14,14,14,1,Greater MN,2022-07-14
2020-07-14,South Central,571,243,328,243,6,28,17,11,17,1,Greater MN,2022-07-14
2020-07-15,South Central,571,226,345,226,7,28,10,18,10,0,Greater MN,2022-07-14
2020-07-16,South Central,571,228,343,228,5,28,12,16,12,1,Greater MN,2022-07-14
2020-07-17,South Central,571,212,359,212,5,28,13,15,13,2,Greater MN,2022-07-14
2020-07-18,South Central,572,200,372,200,6,28,13,15,13,2,Greater MN,2022-07-14
2020-07-19,South Central,571,204,367,204,9,28,11,17,11,2,Greater MN,2022-07-14
2020-07-20,South Central,571,214,357,214,10,28,12,16,12,1,Greater MN,2022-07-14
2020-07-21,South Central,546,218,328,218,6,28,13,15,13,1,Greater MN,2022-07-14
2020-07-22,South Central,571,242,329,242,7,28,13,15,13,1,Greater MN,2022-07-14
2020-07-23,South Central,571,222,349,214,8,28,18,10,14,4,Greater MN,2022-07-14
2020-07-24,South Central,571,228,343,219,9,28,12,16,9,3,Greater MN,2022-07-14
2020-07-25,South Central,531,180,351,173,7,28,8,20,6,2,Greater MN,2022-07-14
2020-07-26,South Central,542,186,356,179,7,28,8,20,6,2,Greater MN,2022-07-14
2020-07-27,South Central,540,200,340,190,10,28,8,20,6,2,Greater MN,2022-07-14
2020-07-28,South Central,580,226,354,218,8,28,11,17,8,3,Greater MN,2022-07-14
2020-07-29,South Central,580,237,343,228,9,28,11,17,7,4,Greater MN,2022-07-14
2020-07-30,South Central,580,245,335,236,9,28,13,15,9,5,Greater MN,2022-07-14
2020-07-31,South Central,580,236,344,222,14,28,8,20,5,3,Greater MN,2022-07-14
2020-07-01,Southeast,1515,897,618,897,16,260,151,109,151,8,Greater MN,2022-07-14
2020-07-02,Southeast,1517,926,591,926,13,258,157,101,157,7,Greater MN,2022-07-14
2020-07-03,Southeast,1517,871,646,871,15,258,153,105,153,8,Greater MN,2022-07-14
2020-07-04,Southeast,1461,741,720,741,14,254,130,124,130,9,Greater MN,2022-07-14
2020-07-05,Southeast,1461,700,761,700,16,254,119,135,119,11,Greater MN,2022-07-14
2020-07-06,Southeast,1517,724,793,724,17,258,112,146,112,9,Greater MN,2022-07-14
2020-07-07,Southeast,1517,857,660,857,16,258,126,132,126,9,Greater MN,2022-07-14
2020-07-08,Southeast,1521,894,627,894,21,254,138,116,138,7,Greater MN,2022-07-14
2020-07-09,Southeast,1521,900,621,900,15,254,139,115,139,7,Greater MN,2022-07-14
2020-07-10,Southeast,1513,939,574,939,15,254,141,113,141,8,Greater MN,2022-07-14
2020-07-11,Southeast,1457,925,532,925,15,250,157,93,157,7,Greater MN,2022-07-14
2020-07-12,Southeast,1445,852,593,852,21,250,131,119,131,6,Greater MN,2022-07-14
2020-07-13,Southeast,1513,854,659,854,20,254,140,114,140,6,Greater MN,2022-07-14
2020-07-14,Southeast,1513,912,601,912,17,254,150,104,150,5,Greater MN,2022-07-14
2020-07-15,Southeast,1457,881,576,881,11,250,143,107,143,5,Greater MN,2022-07-14
2020-07-16,Southeast,1513,912,601,912,11,254,144,110,144,4,Greater MN,2022-07-14
2020-07-17,Southeast,1513,918,595,918,12,254,145,109,145,3,Greater MN,2022-07-14
2020-07-18,Southeast,1457,900,557,900,11,250,145,105,145,3,Greater MN,2022-07-14
2020-07-19,Southeast,1457,824,633,824,15,250,119,131,119,3,Greater MN,2022-07-14
2020-07-20,Southeast,1513,805,708,805,17,254,132,122,132,4,Greater MN,2022-07-14
2020-07-21,Southeast,1513,902,611,902,16,254,140,114,140,3,Greater MN,2022-07-14
2020-07-22,Southeast,1513,909,604,909,16,254,141,113,141,2,Greater MN,2022-07-14
2020-07-23,Southeast,1457,884,573,869,15,250,146,104,143,3,Greater MN,2022-07-14
2020-07-24,Southeast,1457,933,524,917,16,250,143,107,140,3,Greater MN,2022-07-14
2020-07-25,Southeast,1455,907,548,895,12,250,133,117,129,4,Greater MN,2022-07-14
2020-07-26,Southeast,1473,819,654,809,11,254,123,131,117,6,Greater MN,2022-07-14
2020-07-27,Southeast,1473,828,645,814,14,254,115,139,110,5,Greater MN,2022-07-14
2020-07-28,Southeast,1473,905,568,891,14,254,138,116,132,6,Greater MN,2022-07-14
2020-07-29,Southeast,1473,914,559,905,9,254,153,101,148,5,Greater MN,2022-07-14
2020-07-30,Southeast,1473,903,570,891,14,255,153,102,148,5,Greater MN,2022-07-14
2020-07-31,Southeast,1473,938,535,924,14,255,156,99,149,7,Greater MN,2022-07-14
2020-07-01,Southwest,451,124,327,124,1,22,2,20,2,1,Greater MN,2022-07-14
2020-07-02,Southwest,439,124,315,124,1,22,4,18,4,1,Greater MN,2022-07-14
2020-07-03,Southwest,441,115,326,115,0,20,2,18,2,1,Greater MN,2022-07-14
2020-07-04,Southwest,406,109,297,109,1,19,0,19,0,0,Greater MN,2022-07-14
2020-07-05,Southwest,429,109,320,109,1,19,1,18,1,0,Greater MN,2022-07-14
2020-07-06,Southwest,440,115,325,115,1,22,3,19,3,0,Greater MN,2022-07-14
2020-07-07,Southwest,451,127,324,127,1,22,2,20,2,0,Greater MN,2022-07-14
2020-07-08,Southwest,451,129,322,129,2,22,2,20,2,0,Greater MN,2022-07-14
2020-07-09,Southwest,451,127,324,127,3,22,1,21,1,0,Greater MN,2022-07-14
2020-07-10,Southwest,453,113,340,113,2,22,1,21,1,0,Greater MN,2022-07-14
2020-07-11,Southwest,417,100,317,100,1,19,2,17,2,0,Greater MN,2022-07-14
2020-07-12,Southwest,429,106,323,106,2,19,3,16,3,0,Greater MN,2022-07-14
2020-07-13,Southwest,429,103,326,103,3,22,3,19,3,0,Greater MN,2022-07-14
2020-07-14,Southwest,451,122,329,122,5,22,2,20,2,0,Greater MN,2022-07-14
2020-07-15,Southwest,451,136,315,136,6,22,2,20,2,0,Greater MN,2022-07-14
2020-07-16,Southwest,459,128,331,128,6,14,0,14,0,0,Greater MN,2022-07-14
2020-07-17,Southwest,427,120,307,120,6,21,0,21,0,0,Greater MN,2022-07-14
2020-07-18,Southwest,439,98,341,98,4,19,1,18,1,0,Greater MN,2022-07-14
2020-07-19,Southwest,414,94,320,94,4,19,1,18,1,0,Greater MN,2022-07-14
2020-07-20,Southwest,461,109,352,109,3,22,0,22,0,0,Greater MN,2022-07-14
2020-07-21,Southwest,461,129,332,129,3,22,1,21,1,0,Greater MN,2022-07-14
2020-07-22,Southwest,461,139,322,139,3,22,2,20,2,0,Greater MN,2022-07-14
2020-07-23,Southwest,436,135,301,135,0,22,0,22,0,0,Greater MN,2022-07-14
2020-07-24,Southwest,424,119,305,117,5,21,1,20,1,0,Greater MN,2022-07-14
2020-07-25,Southwest,389,114,275,111,9,19,1,18,1,0,Greater MN,2022-07-14
2020-07-26,Southwest,389,101,288,98,8,19,2,17,2,0,Greater MN,2022-07-14
2020-07-27,Southwest,414,99,315,96,6,20,3,17,2,1,Greater MN,2022-07-14
2020-07-28,Southwest,399,101,298,98,5,18,6,12,5,1,Greater MN,2022-07-14
2020-07-29,Southwest,427,108,319,107,3,18,4,14,3,1,Greater MN,2022-07-14
2020-07-30,Southwest,411,117,294,115,5,22,4,18,4,0,Greater MN,2022-07-14
2020-07-31,Southwest,414,135,279,130,5,20,2,18,2,0,Greater MN,2022-07-14
2020-07-01,State,10551,6410,4141,6410,152,1673,1065,608,1065,85,State,2022-07-14
2020-07-02,State,10521,6386,4135,6386,162,1644,1047,597,1047,75,State,2022-07-14
2020-07-03,State,10482,6097,4385,6097,155,1645,1062,583,1062,83,State,2022-07-14
2020-07-04,State,10460,5541,4919,5541,148,1620,998,622,998,81,State,2022-07-14
2020-07-05,State,10302,5416,4886,5416,163,1619,958,661,958,75,State,2022-07-14
2020-07-06,State,10522,5769,4753,5769,173,1641,962,679,962,68,State,2022-07-14
2020-07-07,State,10559,6336,4223,6336,165,1654,1002,652,1002,79,State,2022-07-14
2020-07-08,State,10602,6547,4055,6547,157,1617,1009,608,1009,76,State,2022-07-14
2020-07-09,State,10554,6647,3907,6647,141,1607,1017,590,1017,74,State,2022-07-14
2020-07-10,State,10284,6350,3934,6350,142,1539,957,582,957,70,State,2022-07-14
2020-07-11,State,10084,5882,4202,5882,142,1496,939,557,939,63,State,2022-07-14
2020-07-12,State,10105,5694,4411,5694,154,1497,845,652,845,60,State,2022-07-14
2020-07-13,State,10551,6070,4481,6070,162,1600,981,619,981,63,State,2022-07-14
2020-07-14,State,10644,6413,4231,6413,175,1622,1034,588,1034,61,State,2022-07-14
2020-07-15,State,10585,6577,4008,6577,175,1615,1019,596,1019,58,State,2022-07-14
2020-07-16,State,10727,6595,4132,6595,163,1603,1066,537,1066,61,State,2022-07-14
2020-07-17,State,10551,6405,4146,6405,169,1579,1023,556,1023,68,State,2022-07-14
2020-07-18,State,10667,6075,4592,6075,156,1613,1017,596,1017,70,State,2022-07-14
2020-07-19,State,10175,5594,4581,5594,134,1507,877,630,877,104,State,2022-07-14
2020-07-20,State,10674,6123,4551,6123,178,1606,972,634,972,75,State,2022-07-14
2020-07-21,State,10575,6554,4021,6554,176,1603,1041,562,1041,76,State,2022-07-14
2020-07-22,State,10617,6714,3903,6714,185,1736,1029,707,1029,77,State,2022-07-14
2020-07-23,State,10439,6535,3904,6505,185,1685,1002,683,995,77,State,2022-07-14
2020-07-24,State,9648,6355,3293,6226,200,1499,1046,453,997,75,State,2022-07-14
2020-07-25,State,9315,5870,3445,5761,182,1414,982,432,933,74,State,2022-07-14
2020-07-26,State,8572,5716,2856,5582,218,1447,995,452,963,60,State,2022-07-14
2020-07-27,State,9180,5817,3363,5687,194,1418,929,489,873,76,State,2022-07-14
2020-07-28,State,9310,6242,3068,6110,194,1449,986,463,923,82,State,2022-07-14
2020-07-29,State,9393,6326,3067,6209,172,1465,1013,452,943,90,State,2022-07-14
2020-07-30,State,10421,7103,3318,6974,201,1742,1252,490,1184,94,State,2022-07-14
2020-07-30,State,560,508,52,504,224,200,133,67,129,97,State,2022-07-14
2020-07-31,State,9860,6633,3227,6492,0,1535,1101,434,1033,97,State,2022-07-14
2020-07-01,West Central,208,95,113,95,0,20,8,12,8,1,Greater MN,2022-07-14
2020-07-02,West Central,211,105,106,105,0,17,7,10,7,1,Greater MN,2022-07-14
2020-07-03,West Central,208,108,100,108,0,20,6,14,6,1,Greater MN,2022-07-14
2020-07-04,West Central,208,92,116,92,0,20,5,15,5,1,Greater MN,2022-07-14
2020-07-05,West Central,208,82,126,82,0,20,4,16,4,1,Greater MN,2022-07-14
2020-07-06,West Central,211,84,127,84,0,17,6,11,6,1,Greater MN,2022-07-14
2020-07-07,West Central,211,99,112,99,0,17,8,9,8,2,Greater MN,2022-07-14
2020-07-08,West Central,211,98,113,98,0,17,8,9,8,2,Greater MN,2022-07-14
2020-07-09,West Central,211,99,112,99,0,17,7,10,7,2,Greater MN,2022-07-14
2020-07-10,West Central,191,85,106,85,2,15,4,11,4,0,Greater MN,2022-07-14
2020-07-11,West Central,208,91,117,91,2,20,7,13,7,0,Greater MN,2022-07-14
2020-07-12,West Central,208,73,135,73,1,20,8,12,8,1,Greater MN,2022-07-14
2020-07-13,West Central,208,76,132,76,0,20,5,15,5,2,Greater MN,2022-07-14
2020-07-14,West Central,208,86,122,86,1,20,7,13,7,1,Greater MN,2022-07-14
2020-07-15,West Central,188,93,95,93,1,18,4,14,4,1,Greater MN,2022-07-14
2020-07-16,West Central,208,104,104,104,2,20,7,13,7,1,Greater MN,2022-07-14
2020-07-17,West Central,208,91,117,91,2,20,5,15,5,0,Greater MN,2022-07-14
2020-07-18,West Central,208,82,126,82,1,20,2,18,2,0,Greater MN,2022-07-14
2020-07-19,West Central,188,70,118,70,2,18,2,16,2,0,Greater MN,2022-07-14
2020-07-20,West Central,208,83,125,83,2,20,1,19,1,0,Greater MN,2022-07-14
2020-07-21,West Central,208,105,103,105,2,20,6,14,6,0,Greater MN,2022-07-14
2020-07-22,West Central,208,99,109,99,0,20,7,13,7,0,Greater MN,2022-07-14
2020-07-23,West Central,208,99,109,99,2,20,5,15,5,0,Greater MN,2022-07-14
2020-07-24,West Central,208,88,120,86,0,20,7,13,7,0,Greater MN,2022-07-14
2020-07-25,West Central,211,76,135,76,0,17,6,11,6,1,Greater MN,2022-07-14
2020-07-26,West Central,211,71,140,71,0,17,9,8,8,1,Greater MN,2022-07-14
2020-07-27,West Central,211,78,133,78,0,17,4,13,3,1,Greater MN,2022-07-14
2020-07-28,West Central,211,101,110,101,0,17,3,14,2,0,Greater MN,2022-07-14
2020-07-29,West Central,211,97,114,97,0,17,6,11,6,0,Greater MN,2022-07-14
2020-07-30,West Central,211,92,119,92,0,17,2,15,2,0,Greater MN,2022-07-14
2020-07-31,West Central,211,70,141,70,NA,17,5,12,5,0,Greater MN,2022-07-14
